a bit	m?t chút, m?t it
a few	m?t ít
a little	nh?, m?t ít
abandon	b?, t? b?
abandoned	b? b? roi, b? ru?ng b?
ability	kh? nang, nang l?c
able	có nang l?c, có tài
about	kho?ng, v?
above	? trên, lên trên
abroad	?, ra nu?c ngoài, ngoài tr?i
absence	s? v?ng m?t
absent	v?ng m?t, ngh?
absolute	tuy?t d?i, hoàn toàn
absolutely	tuy?t d?i, hoàn toàn
absorb	thu hút, h?p thu, lôi cu?n
abuse	l?ng hành, l?m d?ng
academic	thu?c h?c vi?n, dh, vi?n hàn lâm
accent	tr?ng âm, d?u tr?ng âm
accept	ch?p nh?n, ch?p thu?n
acceptable	có th? ch?p nh?n, ch?p thu?n
access	l?i, c?a, du?ng vào
accident	tai n?n, r?i ro
accidental	tình c?, b?t ng?
accidentally	tình c?, ng?u nhiên
accommodation	s? thích nghi, di?u ti?t
accompany	di theo, di cùng, kèm theo
according to	theo, y theo
account	tài kho?n, k? toán; tính toán, tính d?n
accurate	dúng d?n, chính xác, xác dáng
accurately	dúng d?n, chính xác
accuse	t? cáo, bu?c t?i, k?t t?i
achieve	d?t du?c, dành du?c
achievement	thành tích, thành t?u
acid	axit
acknowledge	công nh?n, th?a nh?n
acquire	dành du?c, d?t du?c, ki?m du?c
across	qua, ngang qua
act	hành d?ng, hành vi, c? ch?, d?i x?
action	hành d?ng, hành vi, tác d?ng
active	tích c?c ho?t d?ng, nhanh nh?n
actor	di?n viên
actress	di?n viên
actual	th?c t?, có th?t
actually	hi?n nay, hi?n t?i
adapt	tra, l?p vào
add	c?ng, thêm vào
addition	tính c?ng, phép c?ng
additional	thêm vào, tang thêm
address	d?a ch?, d? d?a ch?
adequate	d?y, d?y d?
adequately	tuong x?ng, th?a dáng
adjust	s?a l?i cho dúng, di?u ch?nh
admiration	s? khâm ph?c,ngu?i kp, thán ph?c
admire	khâm ph?c, thán ph?c
admit	nh?n vào, cho vào, k?t h?p
adopt	nh?n làm con nuôi, b? m? nuôi
adult	ngu?i l?n, ngu?i tru?ng thành; tru?ng thành
advance	s? ti?n b?, ti?n lên; dua lên, d? xu?t
advanced	tiên ti?n, ti?n b?, c?p cao
advantage	s? thu?n l?i, l?i ích, l?i th?
adventure	s? phiêu luu, m?o hi?m
advertise	báo cho bi?t, báo cho bi?t tru?c
advertisement	qu?ng cáo
advertising	s? qu?ng cáo, ngh? qu?ng cáo
advice	l?i khuyên, l?i ch? b?o
advise	khuyên, khuyên b?o, ran b?o
affair	vi?c
affect	làm ?nh hu?ng, tác d?ng d?n
afford	có th?, có d? kh? nang, di?u ki?n
afraid	s?, s? hãi, ho?ng s?
after	sau, d?ng sau, sau khi
afternoon	bu?i chi?u
afterwards	sau này, v? sau, r?i thì, sau d?y
again	l?i, n?a, l?n n?a
against	ch?ng l?i, ph?n d?i
age	tu?i
aged	già di
agency	tác d?ng, l?c; môi gi?i, trung gian
agent	d?i lý, tác nhân
aggressive	xâm lu?c, hung hang
ago	tru?c dây
agree	d?ng ý, tán thành
agreement	s? d?ng ý, tán thành; hi?p d?nh, h?p d?ng
ahead	tru?c, v? phía tru?c
aid	s? giúp d?; thêm vào, ph? vào
aim	s? nh?m , m?c tiêu, ý d?nh; nh?m, t?p trung, hu?ng vào
air	không khí, b?u không khí, không gian
aircraft	máy bay, khí c?u
alarm	báo d?ng, báo nguy
alarming	làm lo s?, làm h?t ho?ng, làm s? hãi
alcohol	ru?u c?n
alcoholic	ru?u; ngu?i nghi?n ru?u
alive	s?ng, v?n còn s?ng, còn t?n t?i
all	t?t c?
all right	t?t, ?n, kh?e m?nh; du?c
allied	lien minh, d?ng minh, thông
allow	cho phép, d? cho
ally	nu?c d?ng minh, liên minh; liên k?t, lien minh, k?t thông gia
alo	nghe
alone	cô don, m?t mình
along	d?c theo, theo; theo chi?u dài, su?t theo
alongside	sát c?nh, k? bên, d?c theo
aloud	l?n ti?ng, to ti?ng
alphabet	b?ng ch? cái, bu?c d?u, di?u co b?n
alphabetical	thu?c b?ng ch? cái
alphabetically	theo th? t? abc
already	dã, r?i, dã… r?i
also	cung, cung v?y, cung th?
alter	thay d?i, bi?n d?i, s?a d?i
alternative	s? l?a ch?n; l?a ch?n
although	m?c dù, d?u cho
altogether	hoàn toàn, h?u nhu; nói chung
always	luôn luôn
amaze	làm ng?c nhiên, làm s?ng s?t
amazed	kinh ng?c, s?ng s?t
amazing	kinh ng?c, s?ng s?t
ambition	hoài bão, khát v?ng
ambulance	xe c?u thuong, xe c?p c?u
among	gi?a, ? gi?a
amount	s? lu?ng, s? nhi?u; lên t?i
amuse	làm cho vui, thích, làm bu?n cu?i
amused	vui thích
amusing	vui thích
analyse	phân tích
analysis	s? phân tích
ancient	xua, c?
and	và
anger	s? t?c gi?n, s? gi?n d?
angle	góc
angrily	t?c gi?n, gi?n d?
angry	gi?n, t?c gi?n
animal	d?ng v?t, thú v?t
ankle	m?t cá chân
anniversary	ngày, l? k? ni?m
announce	báo, thông báo
annoy	ch?c t?c, làm b?c mình; làm phi?n, qu?y nhi?u
annoyed	b? khó ch?u, b?c mình, b? qu?y r?y
annoying	ch?c t?c, làm b?c mình; làm phi?n, qu?y nhi?u
annual	hàng nam, t?ng nam
annually	hàng nam, t?ng nam
another	khác
answer	s? tr? l?i; tr? l?i
anti- prefix	ch?ng l?i
anticipate	th?y tru?c, ch?n tru?c, lu?ng tru?c
anxiety	m?i lo âu, s? lo l?ng
anxious	lo âu, lo l?ng, ban khoan
anxiously	lo âu, lo l?ng, ban khoan
any	m?t ngu?i, v?t nào dó; b?t c?; m?t chút nào, tí nào
anyone	ngu?i nào, b?t c? ai
anything	vi?c gì, v?t gì; b?t c? vi?c gì, v?t gì
anyway	th? nào cung du?c, dù sao chang n?a
anywhere	b?t c? ch? nào, b?t c? noi dâu
apart	v? m?t bên, qua m?t bên
apart from	ngoài… ra
apartment	can phòng, can bu?ng
apologize	xin l?i, t? l?i
apparent	rõ ràng, rành m?ch; b? ngoài, có v?
apparently	nhìn bên ngoài, hình nhu
appeal	s? kêu g?i, l?i kêu g?i; kêu g?i, c?u kh?n
appear	xu?t hi?n, hi?n ra, trình di?n
appearance	s? xu?t hi?n, s? trình di?n
apple	qu? táo
application	s? g?n vào, v?t g?n vào; s? chuyên c?n, chuyên tâm
apply	g?n vào, ghép vào, áp d?ng vào
appoint	b? nhi?m, ch? d?nh, ch?n
appointment	s? b? nhi?m, ngu?i du?c b? nhi?m
appreciate	th?y rõ; nh?n th?c
approach	d?n g?n, l?i g?n; s? d?n g?n, s? l?i g?n
appropriate	thích h?p, thích dáng
approval	s? tán thành, d?ng ý, s? ch?p thu?n
approve	tán thành, d?ng ý, ch?p thu?n
approving	tán thành, d?ng ý, ch?p thu?n
approximate	gi?ng v?i, gi?ng h?t v?i
approximately	kho?ng ch?ng, d? ch?ng
april	tháng tu
area	di?n tích, b? m?t
argue	ch?ng t?, ch? rõ
argument	lý l?
arise	xu?t hi?n, n?y ra, n?y sinh ra
arm	cánh tay; vu trang, trang b?
armed	vu trang
arms	vu khí, binh gi?i, binh khí
army	quân d?i
around	xung quanh, vòng quanh
arrange	s?p x?p, s?p d?t, s?a so?n
arrangement	s? s?p x?p, s?p d?t, s? s?a so?n
arrest	b?t gi?, s? b?t gi?
arrival	s? d?n, s? t?i noi
arrow	tên, mui tên
art	ngh? thu?t, m? thu?t
article	bài báo, d? m?c
artificial	nhân t?o
artificially	nhân t?o
artist	ngh? si
artistic	thu?c ngh? thu?t, thu?c m? thu?t
as	nhu
as soon as	ngay khi
as well	cung, cung nhu
ashamed	ngu?ng, x?u h?
aside	v? m?t bên, sang m?t bên
aside from	ngoài ra, tr? ra
ask	h?i
asleep	ng?, dang ng?
aspect	v? b? ngoài, di?n m?o
assist	giúp, giúp d?; tham d?, có m?t
assistance	s? giúp d?
assistant	ngu?i giúp d?, ngu?i ph? tá; giúp d?, ph? tá
associate	k?t giao, liên k?t, k?t h?p, cho c?ng tác
associated with	liên k?t v?i
association	s? k?t h?p, s? liên k?t
assume	mang, khoác, có, l?y
assure	d?m b?o, cam doan
at first	tr?c ti?p
at least	ít ra, ít nh?t, chí ít
atmosphere	khí quy?n
atom	nguyên t?
attach	g?n, dán, trói, bu?c
attached	g?n bó
attack	s? t?n công, s? công kích; t?n công, công kích
attempt	s? c? g?ng, s? th?; c? g?ng, th?
attempted	c? g?ng, th?
attend	d?, có m?t
attention	s? chú ý
attitude	thái d?, quan di?m
attorney	ngu?i du?c ?y quy?n
attract	hút; thu hút, h?p d?n
attraction	s? hút, s?c hút
attractive	hút, thu hút, có duyên, lôi cu?n
audience	thính, khan gi?
august	tháng tám
aunt	cô, dì
author	tác gi?
authority	uy quy?n, quy?n l?c
automatic	t? d?ng
autumn	mùa thu
available	có th? dùng du?c, có giá tr?, hi?u l?c
average	trung bình, s? trung bình, m?c trung bình
avoid	tránh, tránh xa
awake	dánh th?c, làm th?c d?y
award	ph?n thu?ng; t?ng, thu?ng
aware	bi?t, nh?n th?c, nh?n th?c th?y
away	xa, xa cách, r?i xa, di xa
awful	oai nghiêm, d? s?
awkward	v?ng v?, lung túng
back	lung, v? phía sau, tr? l?i
background	phía sau; n?n
backward	v? phía sau, lùi l?i
bacteria	vi khu?n
bad	x?u, t?i
bad-tempered	x?u tính, d? n?i cáu
badly	x?u, t?i
bag	bao, túi, c?p xách
baggage	hành lý
bake	nung, nu?ng b?ng lò
balance	cái cân; làm cho cân b?ng, tuong x?ng
ball	qu? bóng
ban	c?m, c?m ch?; s? c?m
band	bang, dai, n?p
bandage	d?i bang; bang bó
bank	b?  , dê
bar	quán bán ru?u
bargain	s? m?c c?, s? giao kèo mua bán
barrier	d?t chu?ng ng?i v?t
base	co s?, co b?n, n?n móng; d?t tên, d?t co s? trên cái gì
basic	co b?n, co s?
basically	co b?n, v? co b?n
basis	n?n t?ng, co s?
bath	s? t?m
bathroom	bu?ng t?m, nhà v? sinh
battery	pin, ?c quy
battle	tr?n dánh, chi?n thu?t
bay	gian ; bays: vòng nguy?t qu?
be going to	s?p s?a, có ý d?nh
be sick	b? ?m
beach	bãi bi?n
beak	m? chim
bear	mang, c?m, vác, deo, ôm
beard	râu
beat	ti?ng d?p, s? d?p; dánh d?p, d?m
beautiful	d?p
beautifully	t?t d?p, dáng hài lòng
beauty	v? d?p, cái d?p; ngu?i d?p
because	b?i vì, vìbecause of prep. vì, do b?i
become	tr? thành, tr? nên
bed	cái giu?ng
bedroom	phòng ng?
beef	th?t bò
beer	ru?u bia
before	tru?c, d?ng tru?c
begin	b?t d?u, kh?i d?u
beginning	ph?n d?u, lúc b?t d?u, lúc kh?i d?u
behalf	s? thay m?t
behave	d?i x?, an ?, cu x?
behind	sau, ? d?ng sau
belief	lòng tin, d?c tin, s? tin tu?ng
believe	tin, tin tu?ng
bell	cái chuông, ti?ng chuông
belong	thu?c v?, c?a, thu?c quy?n s? h?u
below	? du?i, du?i th?p, phía du?i
belt	dây lung, th?t lung
bend	ch? r?, ch? u?n; khu?u tay; cúi xu?ng, u?n cong
beneath	? du?i, du?i th?p
benefit	l?i, l?i ích; giúp ích, làm l?i cho
bent	khi?u, s? thích, khuynh hu?ng
beside	bên c?nh, so v?i
bet	dánh cu?c, cá cu?c; s? dánh cu?c
betting	s? dánh cu?c
between	gi?a, ? gi?a
beyond	? xa, phía bên kia
bicycle	xe d?p
bid	d?t giá, tr? giá; s? d?t giá, s? tr? giá
big	to, l?n
bill	hóa don, gi?y b?c
bin	thùng, thùng d?ng ru?u
biology	sinh v?t h?c
bird	chim
birth	s? ra d?i, s? sinh d?
birthday	ngày sinh, sinh nh?t
biscuit	bánh quy
bit	mi?ng, m?nh
bite	c?n, ngo?m; s? c?n, s? ngo?m
bitter	d?ng; d?ng cay, chua xót
bitterly	d?ng, d?ng cay, chua xót
black	den; màu den
blade	lu?i
blame	khi?n trách, m?ng trách; s? khi?n trách, s? m?ng trách
blank	tr?ng, d? tr?ng; s? tr?ng r?ng
blankly	ngây ra, không có th?n
blind	dui, mù
block	kh?i, t?ng ; làm ngan c?n, ngan ch?n
blonde	hoe vàng, mái tóc hoe vàng
blood	máu, huy?t; s? tàn sát, chem gi?t
blow	n? hoa; s? n? hoa
blue	xanh, màu xanh
board	t?m ván; lát ván, lót ván
boat	tàu, thuy?n
body	thân th?, thân xác
boil	sôi, lu?c
bomb	qu? bom; oánh bom, th? bom
bone	xuong
book	sách; ghi chép
boot	giày ?ng
border	b?, mép, v?a, l?
bore	bu?n chán, bu?n t?
boring	bu?n chán
born: be born	sinh, d?
borrow	vay, mu?n
boss	ông ch?, th? tru?ng
both	c? hai
bother	làm phi?n, qu?y r?y, làm b?c mình
bottle	chai, l?
bottom	ph?n du?i cùng, th?p nh?t; cu?i, cu?i cùng
bound	nh?t d?nh, ch?c ch?n
bowl	cái bát
box	h?p, thùng
boy	con trai, thi?u niên
boyfriend	b?n trai
brain	óc não; d?u óc, trí não
branch	ngành; nhành cây, nhánh song, ng? du?ng
brand	nhãn
brave	gan d?, can d?m
bread	bánh m?
break	b? gãy, d?p v?; s? gãy, s? v?
breakfast	b?a di?m tâm, b?a sáng
breast	ng?c, vú
breath	hoi th?, hoi
breathe	hít, th?
breathing	s? hô h?p, s? th?
breed	nuôi du?ng, cham sóc, giáo d?c; sinh d?; nòi gi?ng
brick	g?ch
bridge	cái c?u
brief	ng?n, g?n, v?n t?t
briefly	ng?n, g?n, v?n t?t, tóm t?t
bright	sáng, sáng chói
brightly	sáng chói, tuoi
brilliant	t?a sáng, r?c r?, chói l?i
bring	mang, c?m , xách l?i
broad	r?ng
broadcast	tung ra kh?p noi,truy?n r?ng rãi; phát thanh, qu?ng bá
broadly	r?ng, r?ng rãi
broken	b? gãy, b? v?
brother	anh, em trai
brown	nâu, màu nâu
brush	bàn ch?i; ch?i, quét
bubble	bong bóng, b?t, tam
budget	ngân sách
build	xây d?ng
building	s? xây d?ng, công trình xây d?ng; tòa nhà bindinh
bullet	d?n
bunch	búi, chùm, bó, c?m, bu?ng; b?y, dàn
burn	d?t, d?t cháy, th?p, nung, thiêu
burnt	b? d?t, b? cháy, khê; rám n?ng, s?m
burst	n?, n? tung ; háo h?c
bury	chôn c?t, mai táng
bus	xe buýt
bush	b?i cây, b?i r?m
business	vi?c buôn bán, thuong m?i, kinh doanh
busy	b?n, b?n r?n
but	nhung
butter	bo
button	cái nút, cái khuy, cúc
buy	mua
buyer	ngu?i mua
by	b?i, b?ng
by means of	b?ng phuong ti?n
bye exclamation	t?m bi?t
cabinet	t? có nhi?u ngan d?ng d?
cable	dây cáp
cake	bánh ng?t
calculate	tính toán
calculation	s? tính toán
call	g?i; ti?ng kêu, ti?ng g?i
calm	yên l?ng, làm d?u di; s? yên l?ng, s? êm ?
calmly	yên l?ng, êm ?; bình tinh, di?m tinh
came	d?n, di
camera	máy ?nh
camp	tr?i, ch? c?m tr?i; c?m tr?i, h? tr?i
campaign	chi?n d?ch, cu?c v?n d?ng
camping	s? c?m tr?i
can modal	có th?; nhà tù, nhà giam, bình, ca d?ng
cancel	h?y b?, xóa b?
cancer	b?nh ung thu
candidate	ngu?i ?ng c?, thí sinh, ngu?i d? thi
candy	k?o
cannot	không th?
cap	mu lu?i trai, mu v?i
capable	có tài, có nang l?c; có kh? nang, c? gan
capacity	nang l?c, kh? nang ti?p thu, nang su?t
capital	th? dô, ti?n v?n; ch? y?u, chính y?u, co b?n
captain	ngu?i c?m d?u, ngu?i ch? huy, th? linh
capture	b?t gi?, b?t; s? b?t gi?, s? b? b?t
car	xe hoi
card	th?, thi?p
cardboard	bìa c?ng, các tông
care	s? cham sóc, cham nom; cham sóc
career	ngh? nghi?p, s? nghi?p
careful	c?n th?n, c?n tr?ng, bi?t gi? gìn
carefully	c?n th?n, chu dáo
careless	so su?t, c?u th?
carpet	t?m th?m, th?m
carrot	c? cà r?t
carry	mang, vác, khuân ch?
case	v?, ngan, túi
cash	ti?n, ti?n m?t
cast	quang, ném, th?, dánh g?c; s? quang, s? ném
castle	thành trì, thành quách
cat	con mèo
catch	b?t l?y, n?m l?y, tóm l?y, ch?p l?y
category	h?ng, lo?i; ph?m trù
cause	nguyên nhân, nguyên do; gây ra, gây nên
cease	d?ng, ng?ng, ng?t, thôi, h?t, t?nh
ceiling	tr?n nhà
celebrate	k? ni?m, làm l? k? ni?m; tán duong, ca t?ng
celebration	s? k? ni?m, l? k? ni?m; s? tán duong, s? ca t?ng
cell	ô, ngan
cellphone	di?n tho?i di d?ng
cent	d?ng xu
centimetre	xen ti met
central	trung tâm, ? gi?a, trung uong
centre	di?m gi?a, trung tâm, trung uong
century	th? k?
ceremony	nghi th?c, nghi l?
certain	ch?c ch?n
certainly	ch?c ch?n, nh?t d?nh
certificate	gi?y ch?ng nh?n, b?ng, ch?ng ch?
chain	dây, xích; xính l?i, trói l?i
chair	gh?
chairman, chairwoman	ch? t?ch, ch? t?a
challenge	s? th? thách, s? thách th?c; thách th?c, th? thách
chamber	bu?ng, phòng, bu?ng ng?
chance	s? may m?n
change	thay d?i, s? thay d?i, s? bi?n d?i
channel	kênh , eo bi?n
chapter	chuong
character	tính cách, d?c tính, nhân v?t
characteristic	riêng, riêng bi?t, d?c trung, d?c tính, d?c di?m
charge	nhi?m v?, b?n ph?n, trách nhi?m; giao nhi?m v?, giao vi?c
charity	lòng t? thi?n, lòng nhân d?c; s? b? thí
chart	d? th?, bi?u d?; v? d? th?, l?p bi?u d?
chase	san b?t; s? san b?t
chat	nói chuy?n, tán g?u; chuy?n phi?m, chuy?n g?u
cheap	r?
cheaply	r?, r? ti?n
cheat	l?a, l?a d?o; trò l?a d?o, trò gian l?n
check	ki?m tra; s? ki?m tra
cheek	má
cheerful	vui m?ng, ph?n kh?i, h? h?i
cheerfully	vui v?, ph?n kh?i
cheese	pho mát
chemical	thu?c hóa h?c; ch?t hóa h?c, hóa ch?t
chemist	nhà hóa h?c
chemist’s	hóa h?c, môn hóa h?c, ngành hóa h?c
cheque	séc
chest	t?, ruong, hòm
chew	nhai, ng?m nghi
chicken	gà, gà con, th?t gà
chief	tr?ng y?u, chính y?u; th? linh, lãnh t?, ngu?i d?ng d?u, x?p
child	d?a bé, d?a tr?
chin	c?m
chip	v? bào, m?nh v?, ch? s?t, m?
chocolate	sô cô la
choice	s? l?a ch?n
choose	ch?n, l?a ch?n
chop	ch?t, d?n, ch?
church	nhà th?
ch? huycomment	l?i bình lu?n, l?i chú gi?i; bình lu?n, phê bình, chú thích,
cigarette	di?u thu?c lá
circle	du?ng tròn, hình tròn
circumstance	hoàn c?nh, tru?ng h?p, tình hu?ng
citizen	ngu?i thành th?
city	thành ph?
civil	công dân
claim	dòi h?i, yêu sách; s? dòi h?i, s? yêu sách, s? th?nh c?u
clap	v?, v? tay; ti?ng n?, ti?ng v? tay
class	l?p h?c
classic	c? di?n, kinh di?n
classroom	l?p h?c, phòng h?c
clean	s?ch, s?ch s?;
clearly	rõ ràng, sáng s?a
clerk	thu ký, linh m?c, m?c su
clever	lanh l?i, thông minh. tài gi?i, khéo léo
click	làm thành ti?ng lách cách; ti?ng lách cách, cú nh?p
client	khách hàng
climate	khí h?u, th?i ti?t
climb	leo, trèo
climbing	s? leo trèo
clock	d?ng h?
close	dóng kín, ch?t ch?i, che d?y
closed	b?o th?, không c?i m?, khép kín
closely	ch?t ch?, k? lu?ng, t? m?
closet	bu?ng, phòng d? d?, phòng kho
cloth	v?i, khan tr?i bàn, áo th?y tu
clothes	qu?n áo
clothing	qu?n áo, y ph?c
cloud	mây, dám mây
club	câu l?c b?; g?y, dùi cui
coach	hu?n luy?n viên
coal	than dá
coast	s? lao d?c; b? bi?n
coat	áo choàng
code	m?t mã, lu?t, di?u l?
coffee	cà phê
coin	ti?n kim lo?i
cold	l?nh, s? l?nh l?o, l?nh nh?t
coldly	l?nh nh?t, h? h?ng, vô tâm
collapse	d?, s?p d?; s? d? nát, s? s?p d?
colleague	b?n d?ng nghi?p
collect	suu t?p, t?p trung l?i
collection	s? suu t?p, s? t? h?p
college	tru?ng cao d?ng, tru?ng d?i h?c
colour	màu s?c; tô màu
coloured	mang màu s?c, có màu s?c
column	c?t , m?c
combination	s? k?t h?p, s? ph?i h?p
combine	k?t h?p, ph?i h?p
come	d?n, t?i, di d?n, di t?i
comedy	hài k?ch
comfort	s? an ?i, khuyên gi?i, l?i d?ng viên, s? an nhàn; d? dành, an
comfortable	tho?i mái, ti?n nghi, d?y d?
comfortably	d? ch?u, tho?i mái, ti?n nghi, ?m cúng
command	ra l?nh, ch? huy; l?nh, m?nh l?nh, quy?n ra l?nh, quy?n
commercial	buôn bán, thuong m?i
commission	h?i d?ng, ?y ban, s? ?y nhi?m, s? ?y thác; ?y nhi?m, ?y
commit	giao, g?i, ?y nhi?m, ?y thác; t?ng giam, b? tù
commitment	s? ph?m t?i, s? t?n t?y, t?n tâm
committee	?y ban
common	công, công c?ng, thông thu?ng, ph? bi?n
commonly	thông thu?ng, bình thu?ng
communicate	truy?n, truy?n d?t; giao thi?p, liên l?c
communication	s? giao ti?p, liên l?c, s? truy?n d?t, truy?n tin
community	dân chúng, nhân dân
company	công ty
compare	so sánh, d?i chi?u
comparison	s? so sánh
compete	dua tranh, ganh dua, c?nh tranh
competition	s? c?nh tranh, cu?c thi, cu?c thi d?u
competitive	c?nh tranh, dua tranh
complain	phàn nàn, kêu ca
complaint	l?i than phi?n, than th?; s? khi?u n?i, don ki?n
complete	hoàn thành, xong;
completely	hoàn thành, d?y d?, tr?n v?n
complex	ph?c t?p, r?c r?i
complicate	làm ph?c t?p, r?c r?i
complicated	ph?c t?p, r?c r?i
computer	máy tính
concentrate	t?p trung
concentration	s? t?p trung, noi t?p trung
concept	khái ni?m
concern	liên quan, dính líu t?i; s? liên quan, s? dính líu t?i
concerned	có liên quan, có dính líu
concerning	bâng khuâng, ái ng?i
concert	bu?i hòa nh?c
conclude	k?t lu?n, k?t thúc, ch?m d?t
conclusion	s? k?t thúc, s? k?t lu?n, ph?n k?t lu?n
concrete	b?ng bê tông; bê tông
condition	di?u ki?n, tình c?nh, tình th?
conduct	di?u khi?n, ch? d?o, ch? huy; s? di?u khi?n, ch?
conference	h?i ngh?, s? bàn b?c
confidence	lòng tin tu?ng, s? tin c?y
confident	tin tu?ng, tin c?y, t? tin
confidently	t? tin
confine	giam gi?, h?n ch?
confined	h?n ch?, gi?i h?n
confirm	xác nh?n, ch?ng th?c
conflict	xung d?t, va ch?m; s? xung d?t, s? va ch?m
confront	d?i m?t, d?i di?n, d?i chi?u
confused	b?i r?i, lúng túng, ngu?ng
confusing	khó hi?u, gây b?i r?i
confusion	s? l?n x?n, s? r?i lo?n
congratulations	s? chúc m?ng, khen ng?i; l?i chúc m?ng, khen
congress	d?i h?i, h?i ngh?, qu?c h?i
connect	k?t n?i, n?i
connection	s? k?t n?i, s? giao k?t
conscious	t?nh táo, có ý th?c, bi?t rõ
consequence	k?t qu?, h?u qu?
conservative	th?n tr?ng, dè d?t, b?o th?
consider	cân nh?c, xem xét; d? ý, quan tâm, luu ý d?n
considerable	l?n lao, to tát, dáng k?
considerably	dáng k?, l?n lao, nhi?u
consideration	s? cân nh?c, s? xem xét, s? d? ý, s? quan tâm
consist of	g?m có
constant	kiên trì, b?n lòng
constantly	kiên d?nh
construct	xây d?ng
construction	s? xây d?ng
consult	tra c?u, tham kh?o, tham dò, h?i ý ki?n
consumer	ngu?i tiêu dùng
contact	s? liên l?c, s? giao thi?p; ti?p xúc
contain	bao hàm, ch?a d?ng, bao g?m
container	cái d?ng, ch?a; công te no
contemporary	duong th?i, duong d?i
content	n?i dung, s? hài lòng
contest	cu?c thi, tr?n d?u, cu?c tranh lu?n, cu?c chi?n d?u, chi?n tranh
context	van c?nh, khung c?nh, ph?m vi
continent	l?c d?a, d?i l?c
continue	ti?p t?c, làm ti?p
continuous	liên t?c, liên ti?p
continuously	liên t?c, liên ti?p
contract	h?p d?ng, s? ký h?p d?ng; ký k?t
contrast	s? tuong ph?n; làm tuong ph?n, làm trái
contrasting	tuong ph?n
contribute	dóng góp, ghóp ph?n
contribution	s? dóng góp, s? góp ph?n
controlled	du?c di?u khi?n, du?c ki?m tra
convenient	ti?n l?i, thu?n l?i, thích h?p
convention	h?i ngh?, hi?p d?nh, quy u?c
conventional	quy u?c
conversation	cu?c dàm tho?i, cu?c trò chuy?n
convert	d?i, bi?n d?i
convince	làm cho tin, thuy?t ph?c; làm cho nh?n th?c th?y
cook	n?u an, ngu?i n?u an
cooker	lò, b?p, n?i n?u
cookie	bánh quy
cooking	s? n?u an, cách n?u an
cool	mát m?, di?m tinh; làm mát,
cope	d?i phó, duong d?u
copy	b?n sao, b?n chép l?i; s? sao chép; sao chép, b?t chu?c
core	nòng c?t, h?t nhân; dáy lòng
corner	góc
correct	dúng, chính xác; s?a, s?a ch?a
correctly	dúng, chính xác
cost	giá, chi phí; tr? giá, ph?i tr?
cottage	nhà tranh
cotton	bông, ch?, s?i
cough	ho, s? ho, ti?ng hoa
coughing	ho
could	có th?, có kh? nang
could modal	có th?
council	h?i d?ng
count	d?m, tính
counter	qu?y hàng, qu?y thu ti?n, máy d?m
country	nu?c, qu?c gia, d?t nu?c
countryside	mi?n quê, mi?n nông thôn
county	h?t, t?nh
couple	dôi, c?p; dôi v? ch?ng, c?p nam n?
courage	s? can d?m, s? dung c?m, dung khí
course	ti?n trình, quá trình di?n ti?n; sân ch?y dua
court	sân, sân , tòa án, quan tòa, phiên tòa
cousin	anh em h?
cover	bao b?c, che ph?; v?, v? b?c
covered	có mái che, kín dáo
covering	s? bao b?c, s? che ph?, cái bao, b?c
cow	con bò cái
crack	c?, xu?t s?c; làm n?t, làm v?, n?t n?, r?n n?t
cracked	r?n, n?t
craft	ngh?, ngh? th? công
crash	v?i thô; s? roi , s? phá s?n, s?p d?; phá tan tành, phá v?n
crazy	diên, m?t trí
cream	kem
create	sáng t?o, t?o nên
creature	sinh v?t, loài v?t
credit	s? tin, lòng tin, danh ti?ng; ti?n g?i ngân hàng
credit card	th? tín d?ng
crime	t?i, t?i ác, t?i ph?m
criminal	có t?i, ph?m t?i; k? ph?m t?i, t?i ph?m
crisis	s? kh?ng ho?ng, con kh?ng ho?ng
crisp	giòn
criterion	tiêu chu?n
critical	phê bình, phê phán; khó tính
criticism	s? phê bình, s? phê phán, l?i phê bình, l?i phê phán
criticize	phê bình, phê phán, ch? trích
crop	v? mùa
cross	cây thánh giá, n?i th?ng kh?; s? bang qua; bang qua, vu?t qua
crowd	dám dông
crowded	dông dúc
crown	vuong mi?n, vua, ngai vàng; d?nh cao nh?t
crucial	quy?t d?nh, c?t y?u, ch? y?u
cruel	d?c ác, d? t?n, tàn nh?n
crush	ép, v?t, dè nát, dè b?p
cry	khóc, kêu la; s? khóc, ti?ng khóc, s? kêu la
cultural	van hóa
culture	van hóa, s? m? mang, s? giáo d?c
cup	tách, chén
cupboard	1 lo?i t? có ngan
curb	ki?m ch?, nén l?i, h?n ch?
cure	ch?a tr?, di?u tr?; cách ch?a b?nh, cách di?u tr?; thu?c
curious	ham mu?n, tò mò, l? lùng
curiously	tò mò, hi?u k?, l? k?
curl	quan, xo?n, u?n quan, làm xo?n; s? u?n quan
curly	quan, xo?n
current	hi?n hành, ph? bi?n, hi?n nay; dòng
currently	hi?n th?i, hi?n nay
curtain	màn
curve	du?ng cong, du?ng vòng; cong, u?n cong, b? cong
curved	cong
custom	phong t?c, t?c l?, thói quen, t?p quán
customer	khách hàng
customs	thu? nh?p kh?u, h?i quan
cut	c?t, ch?t; s? c?t
cycle	chu k?, chu trình, vòng; quay vòng theo chu k?, di xe d?p
cycling	s? di xe d?p
dad	b?, cha
daily	hàng ngày
damage	m?i h?n, di?u h?i, s? thi?t h?i; làm hu h?i, làm h?ng, gây thi?t h?i
damp	?m, ?m u?t, ?m th?p
dance	s? nh?y múa, s? khiêu vu; nh?y múa, khiêu vu
dancer	di?n viên múa, ngu?i nh?y múa
dancing	s? nh?y múa, s? khiêu vu
danger	s? nguy hi?m, m?i hi?m nghèo; nguy co, m?i de d?a
dangerous	nguy hi?m
dare	dám, dám duong d?u v?i; thách
dark	t?i, t?i tam; bóng t?i, ám mu?i
data	s? li?u, d? li?u
date	ngày, k?, k? h?n, th?i k?, th?i d?i; d? ngày tháng, ghi niên hi?u
daughter	con gái
day	ngày, ban ngày
dead	ch?t, t?t
deaf	di?c, làm thinh, làm ngo
deal	phân phát, phân ph?i; s? giao d?ch, th?a thu?n mua bán
deal with	gi?i quy?t
dear	thân, thân yêu, thân m?n; kính thua, thua
death	s? ch?t, cái ch?t
debate	cu?c tranh lu?n, cu?c tranh cãi; tranh lu?n, bàn cãi
debt	n?
decade	th?p k?, b? mu?i, nhóm mu?i
decay	tình tr?ng suy tàn, suy s?p, tình tr?ng d? nát
december	tháng mu?i hai, tháng ch?p
decide	quy?t d?nh, gi?i quy?t, phân x?
decision	s? quy?t d?nh, s? gi?i quy?t, s? phân x?
declare	tuyên b?, công b?
decline	s? suy tàn, s? suy s?p; suy s?p, suy tàn
decorate	trang hoàng, trang trí
decoration	s? trang hoàng, d? trang hoàng, trang trí
decorative	d? trang hoàng, d? trang trí, d? làm c?nh
decrease	gi?m b?t, làm suy gi?m, s? gi?m di, s? gi?m sút
deep	sâu, khó lu?ng, bí ?n
deeply	sâu, sâu xa, sâu s?c
defeat	dánh th?ng, dánh b?i; s? th?t b?i
defence	cái d? b?o v?, v?t d? ch?ng d?, s? che ch?
defend	che ch?, b?o v?, bào ch?a
define	d?nh nghia
definite	xác d?nh, d?nh rõ, rõ ràng
definitely	r?ch ròi, d?t khoát
definition	s? d?nh nghia, l?i d?nh nghia
degree	m?c d?, trình d?; b?ng c?p; d?
delay	s? ch?m tr?, s? trì hoãn, s? c?n tr?; làm ch?m tr?
deliberate	th?n tr?ng, có tính toán, ch? tâm, có suy nghi cân nh?c
deliberately	th?n tr?ng, có suy nghi cân nh?c
delicate	thanh nhã, thanh tú, t? nh?, khó x?
delight	s? vui thích, s? vui su?ng, di?u thích thú; làm vui thích, làm say
delighted	vui m?ng, hài lòng
deliver	c?u kh?i, thoát kh?i, bày t?, giãi bày
delivery	s? phân phát, s? phân ph?i, s? giao hàng; s? bày t?, phát bi?u
demand	s? dòi h?i, s? yêu c?u; dòi h?i, yêu c?u
demonstrate	ch?ng minh, gi?i thích; bày t?, bi?u l?
dentist	nha si
deny	t? ch?i, ph?n d?i, ph? nh?n
department	c?c, s?, ty, ban, khoa; gian hàng, khu bày hàng
departure	s? r?i kh?i, s? di, s? kh?i hành
depend	ph? thu?c, tùy thu?c; d?a vào, ? vào, trông mong vào
deposit	v?t g?i, ti?n g?i, ti?n d?t c?c; g?i, d?t c?c
depress	làm chán n?n, làm phi?n mu?n; làm suy gi?m
depressed	chán n?n, th?t v?ng, phi?n mu?n; suy y?u, dình tr?
depressing	làm chán n?n làm thát v?ng, làm trì tr?
depth	chi?u sâu, d? dày
derive	nh?n du?c t?, l?y du?c t?; xu?t phát t?, b?t ngu?n, chuy?n hóa t?
describe	di?n t?, miêu t?, mô t?
description	s? mô t?, s? t?, s? miêu t?
desert	sa m?c; công lao, giá tr?; r?i b?, b? tr?n
deserted	hoang v?ng, không ngu?i ?
deserve	dáng, x?ng dáng
design	s? thi?t k?, k? ho?ch, d? cuong. phác th?o; phác h?a, thi?t k?
desire	u?c mu?n; thèm mu?n, ao u?c
desk	bàn
desperate	li?u m?ng, li?u linh; tuy?t v?ng
desperately	li?u linh, li?u m?ng
despite	dù, m?c dù, b?t ch?p
destroy	phá, phá ho?i, phá hu?, tiêu di?t, tri?t phá
destruction	s? phá ho?i, s? phá h?y, s? tiêu di?t
detail	chi ti?t
detailed	c?n k?, t? m?, nhi?u chi ti?t
determination	s? xác d?nh, s? d?nh rõ; s? quy?t d?nh
determine	xác d?nh, d?nh rõ; quy?t d?nh
determined	dã du?c xác d?nh, dã du?c xác d?nh rõ
develop	phát tri?n, m? r?ng; trình bày, bày t?
development	s? phát tri?n, s? trình bày, s? bày t?
device	k? sách; thi?t b?, d?ng c?, máy móc
devote	hi?n dâng, dành h?t cho
devoted	hi?n cho, dâng cho, dành cho; h?t lòng, nhi?t tình
diagram	bi?u d?
diamond	kim cuong
diary	s? nh?t ký; l?ch ghi nh?
dictionary	t? di?n
die	ch?t, t? tr?n, hy sinh
diet	ch? d? an u?ng, ch? d? an kiêng
difference	s? khác nhau
different	khác, khác bi?t, khác nhau
differently	khác, khác bi?t, khác nhau
difficult	khó, khó khan, gay go
difficulty	s? khó khan, n?i khó khan, di?u c?n tr?
dig	dào b?i, x?i
dinner	b?a trua, chi?u
direct	tr?c ti?p, th?ng, th?ng th?n; g?i, vi?t cho ai, di?u khi?n
direction	s? di?u khi?n, s? ch? huy
directly	tr?c ti?p, th?ng
director	giám d?c, ngu?i di?u khi?n, ch? huy
dirt	d? b?n th?u, d? do b?n, v?t rác ru?i
dirty	b?n th?u, do b?n
disabled	b?t l?c, không có kha nang
disadvantage	s? b?t l?i, s? thi?t h?i
disagree	b?t d?ng, không d?ng ý, khác, không gi?ng; không h?p
disagreement	s? b?t d?ng, s? không d?ng ý, s? khác nhau
disappear	bi?n m?t, bi?n di
disappoint	không làm th?a u?c nguy?n, ý mong d?i; th?t u?c, làm th?t
disappointed	th?t v?ng
disappointing	làm chán ngán, làm th?t v?ng
disappointment	s? chán ngán, s? th?t v?ng
disapproval	s? ph?n d?i, s? không tán thành
disapprove	không tán thành, ph?n d?i, chê
disapproving	ph?n d?i
disaster	tai h?a, th?m h?a
disc	dia
discipline	k? lu?t
discount	s? b?t giá, s? chi?t kh?u, ti?n b?t, chi?t kh?u
discover	khám phá, phát hi?n ra, nh?n ra
discovery	s? khám phá, s? tìm ra, s? phát hi?n ra
discuss	th?o lu?n, tranh lu?n
discussion	s? th?o lu?n, s? tranh lu?n
disease	can b?nh, b?nh t?t
disgust	làm ghê t?m, làm kinh t?m, làm ph?n n?
disgusted	chán ghét, ph?n n?
disgusting	làm ghê t?m, kinh t?m
dish	dia
dishonest	b?t luong, không thành th?t
dishonestly	b?t luong, không luong thi?n
disk	dia, dia hát
dislike	s? không ua, không thích, s? ghét
dismiss	gi?i tán
display	bày t?, phô truong, trung bày; s? bày ra, phô bày, trung bày
dissolve	tan rã, phân h?y, gi?i tán
distance	kho?ng cách, t?m xa
distinguish	phân bi?t, nh?n ra, nghe ra
distribute	phân b?, phân ph?i, s?p x?p, phân lo?i
distribution	s? phân b?, s? phân ph?i, phân phát, s? s?p x?p
district	huy?n, qu?n
disturb	làm m?t yên tinh, làm náo d?ng, qu?y r?y
disturbing	xáo tr?n
divide	chia, chia ra, phân ra
division	s? chia, s? phân chia, s? phân lo?i
divorce	dã ly d?
do	làm
doctor	bác si y khoa, ti?n si
document	van ki?n, tài li?u, tu li?u
dog	chó
dollar	dô la m?
domestic	v?t nuôi trong nhà,  n?i tr?, qu?c n?i
dominate	chi?m uu th?, có ?nh hu?ng, chi ph?i; ki?m ch?
door	c?a, c?a ra vào
dot	ch?m nh?, di?m; c?a h?i môn
double	dôi, hai, kép; cái g?p dôi, lu?ng g?p dôi; làm g?p dôi
doubt	s? nghi ng?, s? ng? v?c; nghi ng?, ng? v?c
down	xu?ng
downstairs	? du?i nhà, ? t?ng du?i; x?ng gác; t?ng du?i
downward	xu?ng, di xu?ng
downwards	xu?ng, di xu?ng
dozen	tá
draft	b?n phác th?o, so d? thi?t k?; phác th?o, thi?t k?
drag	lôi kéo, kéo lê
drama	k?ch, tu?ng
dramatic	nhu k?ch, nhu dóng k?ch, thích h?p v?i sân kh?u
dramatically	d?t ng?t
draw	v?, kéo
drawer	ngu?i v?, ngu?i kéo
drawing	b?n v?, b?c v?, s? kéo
dream	gi?c mo, mo
dress	qu?n áo, m?c , an m?c
drink	d? u?ng; u?ng
drive	lái , dua xe; cu?c dua xe
driver	ngu?i lái xe
driving	s? lái xe, cu?c dua xe
drop	ch?y nh? gi?t, roi, r?t; gi?t
drug	thu?c, du?c ph?m; ma túy
drugstore	hi?u thu?c, c?a hàng du?c ph?m
drum	cái tr?ng, ti?ng tr?ng
drunk	say ru?u
dry	khô, c?n; làm khô, s?y khô
due	d?n k? h?n ; x?ng dáng, thích dáng
due to	vì, do, t?i, nh? có
dull	ch?m hi?u, ngu d?n
dump	d? rác; d?ng rác, noi d? rác
during	trong lúc, trong th?i gian
dust	b?i, rác; r?c , quét b?i, ph?i b?i
duty	s? tôn kính, kính tr?ng; b?n ph?n, trách nhi?m
dying	s? ch?t
each	m?i
each other	nhau, l?n nhau
ear	tai
early	s?m
earn	ki?m
earth	d?t, trái d?t
ease	s? thanh th?n, s? tho?i mái; làm thanh th?n, làm yên tâm, làm d? ch?u
easily	d? dàng
east	hu?ng dông, phía dông,  dông, ? phía dông
eastern	dông
easy	d? dàng, d? tính, ung dung
eat	an
economic	kinh t?
economy	s? ti?t ki?m, s? qu?n lý kinh t?
edge	lu?i, c?nh s?c
edition	nhà xu?t b?n, s? xu?t b?n
editor	ngu?i thu th?p và xu?t b?n, ch? bút
educate	giáo d?c, cho an h?c; rèn luy?n
educated	du?c giáo d?c, du?c dào t?o
education	s? giáo d?c, s? rèn luy?n
effect	hi?u ?ng, hi?u qu?, k?t qu?
effective	có k?t qu?, có hi?u l?c
effectively	có k?t qu?, có hi?u l?c
efficient	có hi?u l?c, có hi?u qu?
efficiently	có hi?u qu?, hi?u nghi?m
effort	s? c? g?ng, s? n? l?c
either	m?i, m?t; cung ph?i th?
elbow	khu?u tay
elderly	có tu?i, cao tu?i
elect	b?u, quy?t d?nh
election	s? b?u c?, cu?c tuy?n c?
electric	di?n, có di?n, phát di?n
electrical	di?n
electricity	di?n, di?n l?c; di?n l?c h?c
electronic	di?n t?
elegant	thanh l?ch, tao nhã
element	y?u tôd, nguyên t?
else	khác, n?a; n?u không
elsewhere	? m?t noi nào khác
email	thu di?n t?; g?i thu di?n t?
embarrass	lúng túng, làm ngu?ng ngh?u; làm r?c r?i, gây khó khan
embarrassed	lúng túng, b?i r?i, ngu?ng; mang n?
embarrassing	làm lúng túng, ngan tr?
embarrassment	s? lúng túng, s? b?i r?i
emerge	n?i lên, hi?n ra; n?i b?t lên
emergency	tình tr?ng kh?n c?p
emotion	x? xúc d?ng, s? c?m d?ng, m?i xác c?m
emotional	c?m d?ng, xúc d?ng, xúc c?m; d? c?m d?ng, d? xúc c?m
emotionally	xúc d?ng
emphasis	s? nh?n m?nh, t?m quan tr?ng
emphasize	nh?n m?nh, làm n?i b?t
empire	d? ch?, d? qu?c
employ	dùng, thuê ai làm gì
employee	ngu?i lao d?ng, ngu?i làm công
employer	ch?, ngu?i s? d?ng lao d?ng
employment	s? thuê mu?n
empty	tr?ng, r?ng; d?, d?c; u?ng, làm c?n
enable	làm cho có th?, có kh? nang; cho phép ai làm gì
encounter	ch?m chán, b?t g?p; s? ch?m trán, s? b?t g?p
encourage	d?ng viên, ?ng h?, giúp d?, làm can d?m, m?nh d?n
encouragement	ni?m c? vu, d?ng viên, khuy?n khích, s? làm can d?m
end	gi?i h?n, s? k?t thúc; k?t thúc, ch?m d?t
ending	s? k?t thúc, s? ch?m d?t; ph?n cu?i, k?t c?c
enemy	k? thù, quân d?ch
energy	nang lu?ng, ngh? l?c, sinh l?c
engage	h?a h?n, cam k?t, dính u?c
engaged	dã dính u?c, dã h?a hôn; dã có ngu?i
engine	máy, d?ng co
engineer	k? su
engineering	ngh? k? su, công vi?c c?a k? su
enjoy	thu?ng th?c, thích thú cái gì, du?c hu?ng, có du?c
enjoyable	thú v?, thích thú
enjoyment	s? thích thú, s? có du?c, du?c hu?ng
enormous	to l?n, kh?ng l?
enough	d?
enquiry	s? di?u tra, s? th?m v?n
ensure	b?o d?m, ch?c ch?n
enter	di vào, gia nh?p
entertain	gi?i trí, ti?p dón, chiêu dãi
entertainer	ngu?i qu?n trò, ngu?i ti?p dãi, chiêu dãi
entertaining	gi?i trí
entertainment	s? gi?i trí, s? ti?p dãi, chiêu dãi
enthusiasm	s? hang hái, s? nhi?t tình
enthusiastic	hang hái, say mê, nhi?t tình
entire	toàn th?, toàn b?
entirely	toàn v?n, tr?n v?n, toàn b?
entitle	cho tiêu d?, cho tên ; cho quy?n làm gì
entrance	s? di vào, s? nh?m ch?c
entry	s? ghi vào s? sách, s? di vào, s? ti?p nh?n
envelope	phong bì
environment	môi tru?ng, hoàn c?nh xung quanh
environmental	thu?c v? môi tru?ng
equal	ngang, b?ng; ngu?i ngang hàng, ngang tài, s?c; b?ng, ngang
equally	b?ng nhau, ngang b?ng
equipment	trang, thi?t b?
equivalent	tuong duong; t?, v?t tuong duong
error	l?i, s? sai sót, sai l?m
escape	tr?n thoát, thoát kh?i; s? tr?n thoát, l?i thoát
especially	d?c bi?t là, nh?t là
essay	bài ti?u lu?n
essential	b?n ch?t, th?c ch?t, c?t y?u; y?u t? c?n thi?t
essentially	v? b?n ch?t, v? co b?n
establish	l?p, thành l?p
estate	tài s?n, di s?n, b?t d?ng s?n
estimate	s? u?c lu?ng, dánh giá; u?c lu?ng, dánh giá
etc	vân vân
euro	don v? ti?n t? c?a liên minh châu âu
even	ngay c?, ngay, l?i còn; b?ng ph?ng, di?m d?m, ngang b?ng
evening	bu?i chi?u, t?i
event	s? vi?c, s? ki?n
eventually	cu?i cùng
ever	t?ng, t? tru?c t?i gi?
every	m?i, m?i
everyone	m?i ngu?i
everything	m?i v?t, m?i th?
everywhere	m?i noi
evidence	di?u hi?n nhiên, di?u rõ ràng
evil	x?u, ác; di?u x?u, di?u ác, di?u tai h?i
ex- prefix	ti?n t? ch? bên ngoài
exact	chính xác, dúng
exactly	chính xác, dúng d?n
exaggerate	cu?ng di?u, phóng d?i
exaggerated	cu?ng di?u, phòng d?i
exam	vi?t t?t c?a examination
examination	s? thi c?, k? thi
examine	th?m tra, khám xét, h?i han
example	thí d?, ví d?
excellent	xu?t s?c, xu?t chúng
except	tr? ra, không k?; tr? phi
exception	s? tr? ra, s? lo?i ra
exchange	trao d?i; s? trao d?i
excite	kích thích, kích d?ng
excited	b? kích thích, b? kích d?ng
excitement	s? kích thích, s? kích d?ng
exciting	h?ng thú, thú v?
exclude	ngan ch?n, lo?i tr?
excluding	ngoài ra, tr? ra
excuse	l?i xin l?i, bào ch?a; xin l?i, tha th?, tha l?i
executive	s? thi hành, ch?p hành;  s? thi hành, ch?p hành
exempli gratia	tr?ng
exercise	bài t?p, s? thi hành, s? th?c hi?n; làm, thi hành, th?c hi?n
exhibit	trung bày, tri?n lãm; v?t trung bày, v?t tri?n lãm
exhibition	cu?c tri?n lãm, trung bày
exist	t?n t?i, s?ng
existence	s? t?n t?i, s? s?ng
exit	l?i ra, s? di ra, thoát ra
expand	m? r?ng, phát tri?n, n?, giãn ra
expect	ch? d?i, mong ngóng; li?u tru?c
expectation	s? mong ch?, s? ch? d?i
expected	du?c ch? d?i, du?c hy v?ng
expense	chi phí
expensive	d?t
experience	kinh nghi?m; tr?i qua, n?m mùi
experienced	có kinh nghi?m, t?ng tr?i, giàu kinh nghi?m
experiment	cu?c thí nghi?m; thí nghi?m
expert	chuyên gia; chuyên môn, thành th?o
explain	gi?i nghia, gi?i thích
explanation	s? gi?i nghia, gi?i thích
explode	d?p tan , làm n?, n?
explore	tham dò, thám hi?m
explosion	s? n?, s? phát tri?n ? ?t
export	xu?t kh?u; hàng xu?t kh?u, s? xu?t kh?u
expose	trung bày, phoi bày
express	di?n t?, bi?u l?, bày t?; nhanh, t?c hành
expression	s? di?n t?, s? bày t?, bi?u l?, s? di?n d?t
extend	gio, du?i ra , dành cho, g?i l?i
extension	s? gio, du?i; s? kéo dài, s? dành cho, g?i l?i
extensive	r?ng rãi, bao quát
extent	quy mô, ph?m vi
extra	thêm, ph?, ngo?i; th? thêm, ph?
extraordinary	d?c bi?t, l? thu?ng, khác thu?ng
extreme	vô cùng, kh?c nghi?t, quá khích, c?c doan; s? quá khích
extremely	vô cùng, c?c d?
eye	m?t
face	m?t, th? di?n; duong d?u, d?i phó, d?i m?t
facility	di?u ki?n d? dàng, s? d? dàng, thu?n l?i
fact	vi?c, s? vi?c, s? ki?n
factor	nhân t?
factory	nhà máy, xí nghi?p, xu?ng
fail	sai, th?t b?i
failure	s? th?t b?i, ngu?i th?t b?i
faint	nhút nhát, y?u ?t
faintly	nhút nhát, y?u ?t
fair	h?p lý, công b?ng; thu?n l?i
fairly	h?p lý, công b?ng
faith	s? tin tu?ng, tin c?y; ni?m tin, v?t d?m b?o
faithful	trung thành, chung th?y, trung th?c
faithfully	trung thành, chung th?y, trung th?c
fall	roi, ngã, s? roi, ngã
fall asleep	ng? thi?p di
fall over	ngã l?n nhào, b? d?
false	sai, nh?m, gi? d?i
fame	tên tu?i, danh ti?ng
familiar	thân thi?t, quen th?c
family	gia dình, thu?c gia dình
famous	ngu?i hâm m?
fancy	tu?ng tu?ng, cho, nghi r?ng; tu?ng tu?ng
far	xa
farm	trang tr?i
farmer	nông dân, ngu?i ch? tr?i
farming	công vi?c tr?ng tr?t, d?ng áng
fashion	m?t, th?i trang
fashionable	dúng m?t, h?p th?i trang
fast	nhanh
fasten	bu?c, trói
fat	béo, béo b?; m?, ch?t béo
father	cha
faucet	vòi
fault	s? thi?t sót, sai sót
favour	thi?n ý, s? quý m?n; s? d?ng ý; s? chi?u c?
fear	s? s? hãi, e s?; s?, lo ng?i
feather	lông chim
feature	nét d?t bi?t, di?m d?c trung; mô t? nét d?c bi?t, d?c trung c?a...
february	tháng 2
federal	liên bang
fee	ti?n thù lao, h?c phí
feed	cho an, nuôi
feel	c?m th?y
feel sick	bu?n nôn
feeling	s? c?m th?y, c?m giác
fellow	anh chàng , d?ng chí
female	thu?c gi?ng cái; gi?ng cái
fence	hàng rào
festival	l? h?i, d?i h?i liên hoan
fetch	tìm v?, dem v?; làm b?c mình; làm say mê, quy?n ru
fever	con s?t, b?nh s?t
few	ít,vài; m?t ít, m?t vài
field	cánh d?ng, bãi chi?n tru?ng
fight	d?u tranh, chi?n d?u; s? d?u tranh, cu?c chi?n d?u
fighting	s? chi?n d?u, s? d?u tranh
figure	hình dáng, nhân v?t; hình dung, miêu t?
file	h? so, tài li?u
fill	làm d?y, l?p kín
film	phim, du?c d?ng thành phim
final	cu?i cùng, cu?c d?u chung k?t
finally	cu?i cùng, sau cùng
finance	tài chính; tài tr?, c?p v?n
financial	thu?c
find	tìm, tìm th?y
find out sth	khám phá, tìm ra
fine	t?t, gi?i
finely	d?p d?, t? nh?, cao thu?ng
finger	ngón tay
finish	k?t thúc, hoàn thành; s? k?t thúc, ph?n cu?i
finished	hoàn t?t, hoàn thành
fire	l?a; d?t cháy
firm	hãng, công ty; ch?c, kiên quy?t, vung vàng, m?nh m?
firmly	v?ng ch?c, kiên quy?t
first det	th? nh?t, d?u tiên, tru?c h?t; ngu?i, v?t d?u tiên, th? nh?t
fish	cá, món cá; câu cá, b?t cá
fishing	s? câu cá, s? dánh cá
fit	h?p, v?a; thích h?p, x?ng dáng
fix	dóng, g?n, l?p; s?a ch?a, s?a sang
flag	qu?c k?
flame	ng?n l?a
flash	loé sáng, v?t sáng; ánh sáng lóe lên, dèn nháy
flat	b?ng ph?ng, b?t, nh?n; dãy phòng, can phòng, m?t ph?ng
flavour	v?, mùi; cho gia v?, làm tang thêm mùi v?
flesh	th?t
flight	s? b? ch?y, rút ch?y; s? bay, chuy?n bay
float	l?t, lu l?tl; tràn d?y, tràn ng?p
floor	sàn, t?ng
flour	b?t, b?t m?
flow	s? ch?y; ch?y
flower	hoa, bông, dóa, cây hoa
flu	b?nh cúm
fly	bay; s? bay, quãng du?ng bay
flying	bi?t bay; s? bay, chuy?n bay
focus	t?p trung; trung tâm, tr?ng tâm
fold	g?p, vén, x?n; n?p g?p
folding	g?p l?i du?c
follow	di theo sau, theo, ti?p theo
following	ti?p theo, theo sau, sau dây; sau, ti?p theo
food	d? an, th?c, món an
foot	chân, bàn chân
football	bóng dá
for	cho, dành cho...
for instance	ví d? ch?ng h?n
force	s?c m?nh; ép bu?c, cu?ng ép
forecast	s? d? doán, d? báo; d? doán, d? báo
foreign	nu?c ngoài, t? nu?c ngoài, ? nu?c ngoài
forest	r?ng
forever	mãi mãi
forget	quên
forgive	tha, tha th?
fork	cái nia
form	hình th?, hình d?ng, hình th?c; làm thành, du?c t?o thành
formal	hình th?c
formally	chính th?c
former	tru?c, cu, xua, nguyên
formerly	tru?c dây, thu? xua
formula	công th?c, th? th?c, cách th?c
fortune	s? giàu có, s? th?nh vu?ng
forward	? phía tru?c, ti?n v? phía tru?c
found	tìm, tìm th?y
foundation	s? thành l?p, s? sáng l?p; t? ch?c
frame	c?u trúc, h? th?ng; dàn x?p, b? trí
free	mi?n phí, t? do, gi?i phóng, tr? t? do
freedom	s? t? do; n?n t? do
freely	t? do, tho?i mái
freeze	s? dông l?nh, s? giá l?nh; làm dông, làm dóng bang
frequent	thu?ng xuyên
frequently	thu?ng xuyên
fresh	tuoi, tuoi t?n
freshly	tuoi mát, kh?e kho?n
friday	th? sáu
fridge	t? l?nh
friend	ngu?i b?n
friendly	thân thi?n, thân m?t
friendship	tình b?n, tình h?u ngh?
frighten	làm s?, làm ho?ng s?
frightened	ho?ng s?, khi?p s?
frightening	kinh kh?ng, kh?ng khi?p
from	t?
front	m?t; d?ng tru?c, v? phía tru?c
frozen	l?nh giá
fruit	qu?, trái cây
fry	rán, chiên; th?t rán
fuck	quan h? tình d?c
fuel	ch?t d?t, nhiên li?u
full	d?y, d?y d?
fully	d?y d?, hoàn toàn
fun	s? vui dùa, s? vui thích; hài hu?c
function	ch?c nang; h?at d?ng, ch?y
fund	kho, qu?; tài tr?, ti?n b?c, d? ti?n vào công qu?
fundamental	co b?n, co s?, ch? y?u
funeral	l? tang, dám tang
funny	bu?n cu?i, khôi hài
fur	b? da lông thú
furniture	d? d?c
further	xa hon n?a; thêm n?a
further, furthest	c?p so sánh c?a far
future	tuong lai
gain	l?i, l?i ích; giành du?c, ki?m du?c, d?t t?i
gallon	galông 1gl = 4, 54 lít ? anh, 3, 78 lít ? m?
gamble	dánh b?c; cu?c dánh b?c
gambling	trò c? b?c
game	trò choi
gap	dèo, l? h?ng, k? h?; ch? tr?ng
garage	nhà d? ô tô
garbage	lòng, ru?t
garden	vu?n
gas	khí, hoi d?t
gasoline	d?u l?a, d?u h?a, xang
gate	c?ng
gather	t?p h?p; hái, lu?m, thu th?p
gear	co c?u, thi?t b?, d?ng c?
general	chung, chung chung; t?ng
generally	nói chung, d?i th?
generate	sinh, d? ra
generation	s? sinh ra, s? phát sinh ra; th? h?, d?i
generous	r?ng lu?ng, khoan h?ng, hào phóng
generously	r?ng lu?ng, hào phóng
gentle	hi?n lành, d?u dàng, nh? nhàng
gentleman	ngu?i quý phái, ngu?i thu?ng luu
gently	nh? nhàng, êm ái, d?u dàng
genuine	thành th?t, chân th?t; xác th?c
genuinely	thành th?t, chân th?t
geography	d?a lý, khoa d?a lý
get	du?c, có du?c
get off	ra kh?i, thoát kh?i
get on leo	trèo lên
giaalmost	h?u nhu, g?n nhu
giant	ngu?i kh?ng l?, ngu?i phi thu?ng; kh?ng l?, phi thu?ng
gift	quà t?ng
girl	con gái
girlfriend	b?n gái, ngu?i yêu
give	cho, bi?u, t?ng
give birth	sinh ra
give sth away	cho, phát
give sth out	chia, phân ph?i
give up	b?, t? b?
glad	vui lòng, sung su?ng
glass	kính, th?y tinh, cái c?c, ly
glasses	kính deo m?t
global	toàn c?u, toàn th?, toàn b?
glove	bao tay, gang tay
glue	keo, h?; g?n l?i, dán b?ng keo, h?
go	di
go down	di xu?ng
go up	di lên
go wrong	m?c l?i, sai l?m
god	th?n, chúa
gold	vàng; b?ng vàng
good	t?t, hay, tuy?t; di?u t?t, di?u thi?n
good at	ti?n b? ?
good for	có l?i cho
good, well	t?t, kh?e
goodbye	t?m bi?t, l?i chào t?m bi?t
goods	c?a c?i, tài s?n, hàng hóa
govern	cai tr?, th?ng tr?, c?m quy?n
government	chính ph?, n?i các; s? cai tr?
governor	th? linh, ch?; k? th?ng tr?
grab	túm l?y, v?, ch?p l?y
grade	di?m, di?m s?; phân lo?i, x?p lo?i
gradual	d?n d?n, t?ng bu?c m?t
gradually	d?n d?n, t? t?
grain	thóc lúa, h?t, h?t; tính ch?t, b?n ch?t
gram	d?u xanh
grammar	van ph?m
grand	r?ng l?n, vi d?i
grandchild	cháu
granddaughter	cháu gái
grandfather	ông
grandmother	bà
grandparent	ông bà
grandson	cháu trai
grant	cho, ban, c?p; s? cho, s? ban, s? c?p
grass	c?; bãi c?, d?ng c?
grateful	bi?t on, d? ch?u, khoan khoái
grave	m?, d?u huy?n; trang nghiêm, nghiêm tr?ng
gray	xám, hoa râm
great	to, l?n, vi d?i
greatly	r?t, l?m; cao thu?ng, cao c?
green	xanh lá cây
grey	xám, hoa râm
groceries	hàng t?p hóa
grocery	c?a hàng t?p ph?m
ground	m?t d?t, d?t, bãi d?t
group	nhóm
grow	m?c, m?c lên
grow up	l?n lên, tru?ng thành
growth	s? l?n lên, s? phát tri?n
guarantee	s? b?o hành, b?o lãnh, ngu?i b?o lãnh; cam doan, b?o d?m
guard	cái ch?n, ngu?i b?o v?; b?o v?, gác, canh gi?
guess	doán, ph?ng doán; s? doán, s? u?c ch?ng
guest	khách, khách m?i
guide	di?u ch? d?n, ngu?i hu?ng d?n; d?n du?ng, ch? du?ng
guilty	có t?i, ph?m t?i, t?i l?i
gun	súng
guy	bù nhìn, anh chàng, gã
habit	thói quen, t?p quán
hair	tóc
hairdresser	th? làm tóc
half	m?t n?a, ph?n chia dôi, n?a gi?; n?a
hall	d?i s?nh, tòa , h?i tru?ng
hammer	búa
hand	tay, bàn tay; trao tay, truy?n cho
handle	treo, m?c
happen	x?y ra, x?y d?n
happily	sung su?ng, h?nh phúc
happiness	s? sung su?ng, h?nh phúc
happy	vui su?ng, h?nh phúc
hard	c?ng, r?n, hà kh?c; h?t s?c c? g?ng, tích c?c
hardly	kh?c nghi?t, nghiêm kh?c, tàn t?, khó khan
harm	thi?t h?i, t?n hao; làm h?i, gây thi?t h?i
harmful	gây tai h?i, có h?i
harmless	không có h?i
hat	cái mu
hate	ghét; lòng cam ghét, thù h?n
hatred	lòng cam thì, s? cam ghét
have auxiliary	có
have to modal	ph?i
he	nó, anh ?y, ông ?y
head	cái d?u ; ch? huy, lãnh d?i, d?n d?u
headache	ch?ng nh?c d?u
heal	ch?a kh?i, làm lành
health	s?c kh?e, th? ch?t, s? lành m?nh
healthy	kh?e m?nh, lành m?nh
hear	nghe
hearing	s? nghe, thính giác
heart	tim, trái tim
heat	hoi nóng, s?c nóng
heating	s? d?t nóng, s? làm nóng
heaven	thiên du?ng
heavily	n?ng, n?ng n?
heavy	n?ng, n?ng n?
heel	gót chân
height	chi?u cao, d? cao; d?nh, di?m cao
hell	d?a ng?c
hello	xin chào
help	giúp d?; s? giúp d?
helpful	có ích; giúp d?
hence	sau dây, k? t? dây; do dó, vì th?
her	nó, ch? ?y, cô ?y, bà ?y
here	dây, ? dây
hero	ngu?i anh hùng
hers	cái c?a nó, cái c?a cô ?y, cái c?a ch? ?y, cái c?a bà ?y
herself	chính nó, chính cô ta, chính ch? ta, chính bà ta
hesitate	ng?p ng?ng, do d?
hi	xin chào
hide	tr?n, ?n n?p; che gi?u
high	cao, ? m?c d? cao
highlight	làm n?i b?t, nêu b?t; ch? n?i b?t nh?t, d?p, sáng nh?t
highly	t?t, cao; h?t s?c, ? m?c d? cao
highway	du?ng qu?c l?
hill	d?i
him	nó, h?n, ông ?y, anh ?y
himself	chính nó, chính h?n, chính ông ta, chính anh ta
hip	hông
hire	thuê, cho thuê ; s? thuê, s? cho thuê
his	c?a nó, c?a h?n, c?a ông ?y, c?a anh ?y; cái c?a nó, cái c?a h?n, cái c?a ông ?y, cái c?a anh ?y
historical	l?ch s?, thu?c l?ch s?
history	l?ch s?, s? h?c
hit	dánh, d?m, ném trúng; dòn, cú d?m
hoanloose	l?ng, không ch?t
hobby	s? thích riêng
hoever	ai, ngu?i nào, b?t c? ai, b?t c? ngu?i nào, dù ai
hold	c?m, n?m, gi?; s? c?m, s? n?m gi?
hole	l?, l? tr?ng; hang
holiday	ngày l?, ngày ngh?
hollow	r?ng, tr?ng r?ng
holy	linh thiêng; sùng d?o
home	nhà; ? t?i nhà, nu?c mình
homework	bài t?p v? nhà , công vi?c làm ? nhà
honest	luong thi?n, trung th?c, chân th?t
honestly	luong thi?n, trung th?c, chân th?t
honour	danh d?, thanh danh, lòng kính tr?ng
hook	cái móc; b?n l?; lu?i câu
hope	hy v?ng; ngu?n hy v?ng
horn	s?ng
horror	di?u kinh kh?ng, s? ghê r?n
horse	ng?a
hospital	b?nh vi?n, nhà thuong
host	ch? nhà, ch? ti?c; d?n
hot	nóng, nóng b?c
hotel	khách s?n
hour	gi?
house	nhà, can nhà, toàn nhà
household	h?, gia dình;  gia dình
housing	noi an ch?n ?
how	th? nào, nhu th? nào, làm sao, ra sao
however	tuy nhiên, tuy v?y, dù th? nào
huge	to l?n, kh?ng l?
human	con ngu?i, loài ngu?i
humorous	hài hu?c, hóm h?nh
humour	s? hài hu?c, s? hóm h?nh
hungry	dó
hunt	san, di san
hunting	s? di san
hurry	s? v?i vàng, s? g?p rút
hurt	làm b? thuong, gây thi?t h?i
husband	ngu?i ch?ng
ice	bang, nu?c dá
ice cream	kem
idea	ý tu?ng, quan ni?m
ideal	quan ni?m, tu tu?ng; lý tu?ng
ideally	lý tu?ng, dúng nhu lý tu?ng
identify	nh?n bi?t, nh?n ra, nh?n d?ng
identity	cá tính, nét nh?n d?ng; tính d?ng nh?t, gi?ng h?t
if	n?u, n?u nhu
ignore	ph?t l?, t? ra không bi?t d?n
ill	?m
illegal	trái lu?t, b?t h?p pháp
illegally	trái lu?t, b?t h?p pháp
illness	s? dau y?u, ?m, b?nh t?t
illustrate	minh h?a, làm rõ ý
image	?nh, hình ?nh
imaginary	tu?ng tu?ng, ?o
imagination	trí tu?ng tu?ng, s? tu?ng tu?ng
imagine	tu?ng tu?ng, hình dung; tu?ng r?ng, cho r?ng
immediate	l?p t?c, t?c thì
immediately	ngay l?p t?c
immoral	trái d?o d?c, luân lý; x?u xa
impact	s? và ch?m, s? tác d?ng, ?nh hu?ng
impatient	thi?u kiên nh?n, nóng v?i
impatiently	nóng lòng, s?t ru?t
implication	s? lôi kéo, s? liên can, di?u g?i ý
imply	ng? ý, bao hàm
import	s? nh?p, s? nh?p kh?u; nh?p, nh?p kh?u
importance	s? quan tr?ng, t?m quan tr?ng
important	quan tr?ng, h? tr?ng
importantly	quan tr?ng, tr?ng y?u
impose	dánh , b?t gánh vác; dánh tráo, l?i d?ng
impossible	không th? làm du?c, không th? x?y ra
impress	ghi, kh?c, in sâu vào; gây ?n tu?ng, làm c?m d?ng
impressed	du?c ghi, kh?c, in sâu vào
impression	?n tu?ng, c?m giác; s? in, dóng d?u
impressive	g?y ?n tu?ng m?nh; hùng vi, oai v?
improve	c?i thi?n, cái ti?n, m? mang
improvement	s? cái thi?n, s? c?i ti?n, s? m? mang
in	?, t?i, trong; vào
in addition	thêm vào
in advance	tru?c, s?m
in case	n?u......
in charge of	ph? trách
in common	s? chung, c?a chung
in exchange	trong vi?c trao d?i v?
in favour/favor	?ng h? cái gì
in front	? phía tru?c
in general	nói chung, d?i khái
in memory of	s? tu?ng nh?
in order to	h?p l?
in public	gi?a công chúng, công khai
in spite of	m?c dù, b?t ch?p
in the end	cu?i cùng, v? sau
inability	s? b?t l?c, b?t tài
inch	inso
incident	vi?c x?y ra, vi?c có liên quan
include	bao g?m, tính c?
including	bao g?m, k? c?
income	l?i t?c, thu nh?p
increase	tang, tang thêm; s? tang, s? tang thêm
increasingly	tang thêm
indeed	th?t v?y, qu? th?t
independence	s? d?c l?p, n?n d?c l?p
independent	d?c l?p
independently	d?c l?p
index	ch? s?, s? bi?u th?
indicate	ch?, cho bi?t; bi?u th?, trình bày ng?n g?n
indication	s? ch?, s? bi?u th?, s? bi?u l?
indirect	gián ti?p
indirectly	gián ti?p
individual	riêng, riêng bi?t; cá nhân
indoor	trong nhà
indoors	? trong nhà
industrial	công nghi?p, k? ngh?
industry	công nghi?p, k? ngh?
inevitable	không th? tránh du?c, ch?c ch?n x?y ra; v?n thu?ng th?y, nghe
inevitably	ch?c ch?n
infect	nhi?m, tiêm nhi?m, d?u d?c, lan truy?n
infected	b? nhi?m, b? d?u d?c
infection	s? nhi?m, s? d?u d?c
infectious	lây, nhi?m
influence	s? ?nh hu?ng, s? tác d?ng; ?nh hu?ng, tác d?ng
inform	báo cho bi?t, cung c?p tin t?c
informal	không chính th?c, không nghi th?c
information	tin t?c, tài li?u, ki?n th?c
ingredient	ph?n h?p thành, thành ph?n
initial	ban d?u, lúc d?u; ch? d?u
initially	vào lúc ban d?u, ban d?u
initiative	bu?c d?u, s? kh?i d?u
injure	làm t?n thuong, làm h?i, xúc ph?m
injured	b? t?n thuong, b? xúc ph?m
injury	s? làm t?n thuong, làm h?i; di?u h?i, di?u t?n h?i
ink	m?c
inner	? trong, n?i b?; thân c?n
innocent	vô t?i, trong tr?ng, ngây tho
insect	sâu b?, côn trùng
insert	chèn vào, l?ng vào
inside	m?t trong, phía, ph?n trong; ? trong, n?i b?
insist	c? nh?t d?nh, c? khang khang
install	d?t
instance	thí d?, ví d?; tru?ng h?p cá bi?t
instead	d? thay th?
instead of	thay cho
institute	vi?n, h?c vi?n
institution	s? thành l?p, l?p; co quan, tr? s?
instruction	s? d?y, tài li?u cung c?p
instrument	d?ng c? âm nh?c khí
insult	lang m?, x? nh?c; l?i lang m?, s? x? nh?c
insulting	lang m?, x? nh?c
insurance	s? b?o hi?m
intelligence	s? hi?u bi?t, trí thông minh
intelligent	thông minh, sáng trí
intend	ý d?nh, có ý d?nh
intended	có ý d?nh, có d?ng ý
intention	ý d?nh, m?c dích
interest	s? thích thú, s? quan tâm, chú ý; làm quan tâm, làm chú ý
interested	có thích thú, có quan tâm, có chú ý
interesting	làm thích thú, làm quan tâm, làm chú ý
interior	ph?n trong, phía trong; ? trong, ? phía trong
internal	? trong, bên trong, n?i d?a
international	qu?c t?
internet	liên m?ng
interpret	gi?i thích
interpretation	s? gi?i thích
interrupt	làm gián do?n, ng?t l?i
interruption	s? gián do?n, s? ng?t l?i
interval	kho?ng , kho?ng cách
interview	cu?c ph?ng v?n, s? g?p m?t; ph?ng v?n, nói chuy?n riêng
into	vào, vào trong
introduce	gi?i thi?u
introduction	s? gi?i thi?u, l?i gi?i thi?u
invent	phát minh, sáng ch?
invention	s? phát minh, s? sáng ch?
invest	d?u tu
investigate	di?u tra, nghiên c?u
investigation	s? di?u tra, nghiên c?u
investment	s? d?u tu, v?n d?u tu
invitation	l?i m?i, s? m?i
invite	m?i
involve	bao g?m, bao hàm; thu hút, d?n tâm trí
involvement	s? g?m, s? bao hàm; s? d?, d?n h?t tâm trí vào
iron	s?t; b?c s?t
irritate	làm phát cáu, ch?c t?c
irritated	t?c gi?n, cáu ti?t
irritating	làm phát cáu, ch?c t?c
island	hòn d?o
issue	s? phát ra, s? phát sinh; phát hành, dua ra
it	cái dó, di?u dó, con v?t dó
item	tin t?c; kho?n.., món..., ti?t m?c
its	c?a cái dó, c?a di?u dó, c?a con v?t dó; cái c?a di?u dó, cái c?a con v?t dó
itself	chính cái dó, chính di?u dó, chính con v?t dó
jacket	áo vét
jam	m?t
january	tháng giêng
jealous	ghen,, ghen t?
jeans	qu?n bò, qu?n zin
jelly	th?ch
jewellery	n? trang, kim hoàn
job	vi?c, vi?c làm
join	gia nh?p, tham gia; n?i, ch?p, ghép
joint	chung ; ch? n?i, d?u n?i
jointly	cùng nhau, cùng chung
joke	trò cu?i, l?i nói dùa; nói dùa, gi?u c?t
journalist	nhà báo
journey	cu?c hành trình ; quãng du?ng, ch?ng du?ng di
joy	ni?m vui, s? vui m?ng
judge	xét x?, phân x?; quan tòa, th?m phán
judgement	s? xét x?
juice	nu?c ép
july	tháng 7
jump	nh?y; s? nh?y, bu?c nh?y
june	tháng 6
junior	tr? hon, ít tu?i hon; ngu?i ít tu?i hon
just	dúng, v?a d?; v?a m?i, ch?
justice	s? công b?ng
justified	h?p lý, du?c ch?ng minh là dúng
justify	bào ch?a, bi?n h?
keen	s?c, bén
keen on	say mê, ua thích
keep	gi?, gi? l?i
key	chìa khóa, khóa, thu?c
keyboard	bàn phím
kick	dá; cú dá
kid	con dê non
kill	gi?t, tiêu di?t
killing	s? gi?t chóc, s? tàn sát
kilogram	kilôgam
kilometre	kilômet
kind	lo?i, gi?ng; t? t?, có lòng t?t
kindly	t? t?, t?t b?ng
kindness	s? t? t?, lòng t?t
king	vua, qu?c vuong
kiss	hôn, cái hôn
kitchen	b?p
knee	d?u g?i
knife	dan, thêu
knitted	du?c dan, du?c thêu
knitting	vi?c dan; hàng d?t kim
knock	dánh, d?p; cú dánh
knot	cái no; di?m nút, di?m trung tâm
know	bi?t
knowledge	s? hi?u bi?t, tri th?c
label	nhãn, mác; dán nhãn, ghi mác
laboratory, lab	phòng thí nghi?m
labour	lao d?ng; công vi?c
lack	s? thi?u; thi?u
lacking	ngu d?n, ngây ngô
lady	ngu?i yêu, v?, quý bà, ti?u thu
lake	h?
lamp	dèn
land	d?t, d?t canh tác, d?t dai
landscape	phong c?nh
lane	du?ng nh?
language	ngôn ng?
large	r?ng, l?n, to
largely	phong phú, ? m?c d? l?n
last	l?m cu?i, sau cùng; ngu?i cu?i cùng; cu?i cùng, r?t h?t;
late	tr?, mu?n
later	ch?m hon
latest	mu?n nh?t, ch?m nh?t, g?n dây nh?t
latter	sau cùng, g?n dây, m?i dây
laugh	cu?i; ti?ng cu?i
launch	h? th?y ; khai truong; s? h? th?y, bu?i gi?i thi?u s?n ph?m
law	lu?t
lawyer	lu?t su
lay	x?p, d?t, b? trí
layer	l?p
lazy	lu?i bi?ng
lead	lãnh d?o, d?n d?t; s? lãnh d?o, s? hu?ng d?n
leader	ngu?i lãnh d?o, lãnh t?
leading	lãnh d?o, d?n d?u
leaf	lá cây, lá
league	liên minh, liên hoàn
lean	nghiêng, d?a, ? vào
learn	h?c, nghiên c?u
least	t?i thi?u; ít nh?t
leather	da thu?c
leave	b? di, r?i di, d? l?i
leave out	b? quên, b? sót
lecture	bài di?n thuy?t, bài thuy?t trình, bài nói chuy?n
left	bên trái; v? phía trái
leg	chân
legal	h?p pháp
legally	h?p pháp
lemon	qu? chanh
lend	cho vay, cho mu?n
length	chi?u dài, d? dài
less	nh? bé, ít hon; s? lu?ng ít hon
lesson	bài h?c
let	cho phép, d? cho
letter	thu; ch? cái, m?u t?
level	trình d?, c?p, v? trí; b?ng, ngang b?ng
library	thu vi?n
licence	b?ng, ch?ng ch?, b?ng c? nhân; s? cho phép
license	c?p ch?ng ch?, c?p b?ng, cho phép
lid	n?p, vung
lie	nói d?i; l?i nói d?i, s? d?i trá
life	d?i, s? s?ng
lift	gio lên, nh?c lên; s? nâng, s? nh?c lên
light	ánh sáng; nh?, nh? nhàng; d?t, th?p sáng
lightly	nh? nhàng
like	gi?ng nhu; thích; nhu
likely	có th? dúng, có th? x?y ra, có kh? nang; có th?, ch?c v?y
limit	gi?i h?n, ranh gi?i; gi?i h?n, h?n ch?
limited	h?n ch?, có gi?i h?n
line	dây, du?ng, tuy?n
link	m?t xích, m?i liên l?c; liên k?t, k?t n?i
lip	môi
liquid	ch?t l?ng; l?ng, êm ái, du duong, không v?ng
list	danh sách; ghi vào danh sách
listen	nghe, l?ng nghe
literature	van chuong, van h?c
litre	lít
little	nh?, bé, chút ít; không nhi?u; m?t chút
live	s?ng
lively	s?ng, sinh d?ng
living	s?ng, dang s?ng
load	gánh n?ng, v?t n?ng; ch?t, ch?
loan	s? vay mu?n
local	d?a phuong, b? ph?n, c?c b?
locally	có tính ch?t d?a phuong, c?c b?
locate	xác d?nh v? trí, d?nh v?
located	d?nh v?
location	v? trí, s? d?nh v?
lock	khóa; khóa
logic	lô gic
logical	h?p lý, h?p logic
lonely	cô don, bo vo
long	dài, xa; lâu
look	nhìn; cái nhìn
look after	trông nom, cham sóc
look at	nhìn, ng?m, xem
look for	tìm ki?m
look forward to	mong d?i cách hân
loosely	l?ng l?o
lord	chúa, vua
lorry	xe t?i
lose	m?t, thua, l?c
loss	s? m?t, s? thua
lost	thua, m?t
lot	s? lu?ng l?n; r?t nhi?u
loud	to, inh ?i, ?m i; to, l?n
loudly	?m i, inh ?i
love	tình yêu, lòng yêu thuong; yêu, thích
lovely	d?p, xinh x?n, có duyên
lover	ngu?i yêu, ngu?i tình
low	th?p, bé, lùn
loyal	trung thành, trung kiên
luck	may m?n, v?n may
lucky	g?p may, g?p may m?n, h?nh phúc
luggage	hành lý
lump	c?c, t?ng, mi?ng; cái bu?u
lunch	b?a an trua
lung	ph?i
machine	máy, máy móc
machinery	máy móc, thi?t b?
mad	diên, m?t trí; b?c diên ngu?i
magazine	t?p chí
magic	ma thu?t, ?o thu?t;  ma thu?t, ?o thu?t
mail	thu t?, buu ki?n; g?i qua buu di?n
main	chính, ch? y?u, tr?ng y?u nh?t
mainly	chính, ch? y?u, ph?n l?n
maintain	gi? gìn, duy trì, b?o v?
major	l?n, nhi?u hon, tr?ng d?i, ch? y?u
majority	ph?n l?n, da s?, uu th?
make	làm, ch? t?o; s? ch? t?o
make fun of	dùa c?t, ch? gi?u, ch? nh?o
make sth up	làm thành, c?u thành, g?p thành
make sure	ch?c ch?n, làm cho ch?c ch?n
make-up	d? hóa trang, son ph?n
male	trai, tr?ng, d?c; con trai, dàn ông, con tr?ng, d?c
mall	búa
man	con ngu?i; dàn ông
manage	qu?n lý, trông nom, di?u khi?n
management	s? qu?n lý, s? trông nom, s? di?u khi?n
manager	ngu?i qu?n lý, giám d?c
manner	cách, l?i, ki?u; dáng, v?, thái d?
manufacturer	ngu?i ch? t?o, ngu?i s?n xu?t
manufacturing	s? s?n xu?t, s? ch? t?o
many	nhi?u
map	b?n d?
march	di?u hành, hành quân; cu?c hành quân, cu?c di?u hành
mark	d?u, nhãn, nhãn mác; dánh d?u, ghi d?u
market	ch?, th? tru?ng
marketing	ma-k?t-tinh
marriage	s? cu?i xin, s? k?t hôn, l? cu?i
married	cu?i, k?t hôn
marry	cu?i
mass	kh?i, kh?i lu?ng; qu?n chúng, d?i chúng
massive	to l?n, d? s?
master	ch?, ch? nhân, th?y giáo, th?c si
match	tr?n thi d?u, d?i th?, d?ch th?; d?i ch?i, sánh du?c
matching	tính d?ch thù, thi d?u
mate	b?n, b?n ngh?; giao ph?i
material	nguyên v?t li?u; v?t ch?t, h?u hình
mathematics	toán h?c, môn toán
matter	ch?t, v?t ch?t; có ý nghia, có tính ch?t quan tr?ng
maximum	c?c d?, t?i da; tr? s? c?c d?i, lu?ng c?c d?i, c?c d?
may	tháng 5
may modal	có th?, có l?
maybe	có th?, có l?
mayor	th? tru?ng
me	tôi, tao, t?
meal	b?a an
mean	nghia, có nghia là
meaning	ý, ý nghia
means	c?a c?i, tài s?n, phuong ti?n
meanwhile	trong lúc dó, trong lúc ?y
measure	do, do lu?ng; s? do lu?ng, don v? do lu?ng
measurement	s? do lu?ng, phép do
meat	th?t
media	phuong ti?n truy?n thông d?i chúng
medical	y h?c
medicine	y h?c, y khoa; thu?c
medium	trung bình, trung, v?a; s? trung gian, s? môi gi?i
meet	g?p, g?p g?
meeting	cu?c mít tinh, cu?c bi?u tình
melt	tan ra, ch?y ra; làm tan ch?y ra
member	thành viên, h?i viên
membership	tu cách h?i viên, d?a v? h?i viên
memory	b? nh?, trí nh?, k? ni?m
mental	trí tu?, trí óc; m?t trí
mentally	v? m?t tinh th?n
mention	k? ra, nói d?n, d? c?p
menu	th?c don
mere	ch? là
merely	ch?, don thu?n
mess	tình tr?ng b?a b?n, tình tr?ng l?n x?n; ngu?i nh?ch nhác, b?n th?u
message	tin nh?n, thu tín, di?n thông báo, thông di?p
metal	kim lo?i
method	phuong pháp, cách th?c
metre	mét
mid- combining form	ti?n t?: m?t n?a
midday	trua, bu?i trua
middle	gi?a, ? gi?a
midnight	n?a dêm, 12h dêm
might modal	qk. may có th?, có l?
mild	nh?, êm d?u, ôn hòa
mile	d?m
military	quân d?i, quân s?
milk	s?a
milligram	mi-li-gam
millimetre	mi-li-met
mind	tâm trí, tinh th?n, trí tu?; chú ý, d? ý, cham sóc, quan tâm
mine	c?a tôi
mineral	công nhân, th? m?; khoáng
minimum	t?i thi?u; s? lu?ng t?i thi?u, m?c t?i thi?u
minister	b? tru?ng
ministry	b?
minor	nh? hon, th? y?u, không quan tr?ng
minority	ph?n ít, thi?u s?
minute	phút
mirror	guong
miss	cô gái, thi?u n?
missing	v?ng, thi?u, th?t l?c
mistake	l?i, sai l?m, l?i l?m; ph?m l?i, ph?m sai l?m
mistaken	sai l?m, hi?u l?m
mix	pha, tr?n l?n; s? pha tr?n
mixed	l?n l?n, pha tr?n
mixture	s? pha tr?n, s? h?n h?p
mobile	chuy?n d?ng, di d?ng
mobile phone	di?n tho?i di d?ng
model	m?u, ki?u m?u
modern	hi?n d?i, tân ti?n
moment	ch?c, lát
monday	th? 2
money	ti?n
monitor	l?p tru?ng, màn hình máy tính; nghe, ghi phát thanh, giám sát
month	tháng
mood	l?i, th?c, di?u
moon	m?t trang
moral	d?o d?c, luân lý, ph?m h?nh; có d?o d?cmorally adv. có d?o d?c
more	hon, nhi?u hon
moreover	hon n?a, ngoài ra, v? l?i
morning	bu?i sáng
most	l?n nh?t, nhi?u nh?t; nh?t, hon c?
mostly	h?u h?t, ch? y?u là
mother	m?
motion	s? chuy?n d?ng, s? di d?ng
motor	d?ng co mô tô
motorcycle	xe mô tô
mount	leo, trèo; núi
mountain	núi
mouse	chu?t
mouth	mi?ng
move	di chuy?n, chuy?n d?ng; s? di chuy?n, s? chuy?n d?ng
movement	s? chuy?n d?ng, s? ho?t d?ng; c? d?ng, d?ng tác
movie	phim xi nê
movie theater	r?p chi?u phim
moving	d?ng, ho?t d?ng
much	nhi?u, l?m
mud	bùn
multiply	nhân lên, làm tang lên nhi?u l?n; sinh sôi n?y n?
mum	m?
murder	t?i gi?t ngu?i, t?i ám sát; gi?t ngu?i, ám sát
muscle	co, b?p th?t
museum	b?o tàng
music	nh?c, âm nh?c
musical	nh?c, âm nh?c; du duong, êm ái
musician	nh?c si
must modal	ph?i, c?n, nên làm
my	c?a tôi
myself	t? tôi, chính tôi
mysterious	th?n bí, huy?n bí, khó hi?u
mystery	di?u huy?n bí, di?u th?n bí
nail	móng  móng vu?t
naked	tr?n, kh?a thân, tro tr?i
name	tên; d?t tên, g?i tên
narrow	h?p, ch?t h?p
nation	dân t?c, qu?c gia
national	qu?c gia, dân t?c
natural	t? nhiên, thiên nhiên
naturally	v?n, t? nhiên, duong nhiên
nature	t? nhiên, thiên nhiên
navy	h?i quân
near	g?n, c?n; ? g?n
nearby	g?n
nearly	g?n, s?p, suýt
neat	s?ch, ngan n?p; rành m?ch
neatly	g?n gàng, ngan n?p
necessarily	t?t y?u, nh?t thi?t
necessary	c?n, c?n thi?t, thi?t y?u
neck	c?
need modal	c?n, dòi h?i; s? c?n
needle	cái kim, mui nh?n
negative	ph? d?nh
neighbour	hàng xóm
neighbourhood	hàng xóm, làng gi?ng
neither	không này mà cung không kia
nephew	cháu trai
nerve	khí l?c, th?n kinh, can d?m
nervous	ho?ng s?, d? b? kích thích, hay lo l?ng
nervously	b?n ch?n, lo l?ng
nest	t?, ?; làm t?
net	lu?i, m?ng
network	m?ng lu?i, h? th?ng
never	không bao gi?, không khi nào
nevertheless	tuy nhiên, tuy th? mà
new	m?i, m?i m?, m?i l?
newly	m?i
news	tin, tin t?c
newspaper	báo
next	sát, g?n, bên c?nh; l?n sau, ti?p n?a
next to	g?n
nice	d?p, thú v?, d? ch?u
nicely	thú v?, d? ch?u
niece	cháu gái
night	dêm, t?i
no exclamation,	không
nobody	không ai, không ngu?i nào
noise	ti?ng ?n, s? huyên náo
noisily	?n ào, huyên náo
noisy	?n ào, huyên náo
none	không ai, không ngu?i, v?t gì
nonsense	l?i nói vô lý, vô nghia
nor	cung không
normal	thu?ng, bình thu?ng; tình tr?ng bình thu?ng
normally	thông thu?ng, nhu thu?ng l?
north	phía b?c, phuong b?c
northern	b?c
nose	mui
not	không
note	l?i ghi, l?i ghi chép; ghi chú, ghi chép
nothing	không gì, không cái gì
notice	thông báo, y?t th?; chú ý, d? ý, nh?n bi?t
noticeable	dáng chú ý, dáng d? ý
novel	ti?u thuy?t, truy?n
november	tháng 11
now	bây gi?, hi?n gi?, hi?n nay
nowhere	không noi nào, không ? dâu
nuclear	h?t nhân
number	s?
nurse	qu? h?ch; d?u
obey	vâng l?i, tuân theo, tuân l?nh
object	v?t, v?t th?; ph?n d?i, ch?ng l?i
objective	m?c tiêu, m?c dích;  m?c tiêu, khách quan
observation	s? quan sát, s? theo dõi
observe	quan sát, theo dõi
obtain	d?t du?c, giành du?c
obvious	rõ ràng, rành m?ch, hi?n nhiên
obviously	m?t cách rõ ràng, có th? th?y du?c
occasion	d?p, co h?i
occasionally	th?nh tho?ng, dôi khi
occupied	dang s? d?ng, d?y
occupy	gi?, chi?m linh, chi?m gi?
occur	x?y ra, x?y d?n, xu?t hi?n
ocean	d?i duong
odd	k? qu?c, k? c?c, l?
oddly	k? qu?c, k? c?c, l?
of	c?a
of course	di nhiên
off	t?t; kh?i, cách, r?i
offence	s? vi ph?m, s? ph?m t?i
offend	xúc ph?m, làm b?c mình, làm khó ch?u
offensive	s? t?n công, cu?c t?n công
offer	bi?u, t?ng, cho; s? tr? giá
office	co quan, van phòng, b?
officer	viên ch?c, c?nh sát, si quan
official	chính quy?n, van phòng; viên ch?c, công ch?c
officially	m?t cách tr?nh tr?ng, m?t cách chính th?c
often	thu?ng, hay, luôn
oh exclamation	chao, ôi chao, chà, này..
oil	d?u
ok  exclamation,	d?ng ý, tán thành
old	già
old-fashioned	l?i th?i
on	trên, ? trên; ti?p t?c, ti?p di?n
on behalf of sb	thay m?t cho ai, nhân danh ai
on board	trên tàu th?y
on purpose	c? tình, c? ý, có ch? tâm
on sb’s behalf	nhân danh cá nhân ai
once	m?t l?n; khi mà, ngay khi, m?t khi
one number,	m?t; m?t ngu?i, m?t v?t nào dó
onion	c? hành
only	ch? có 1, duy nh?t; ch?, m?i
onto	v? phía trên, lên trên
open	m?, ng?; m?, b?t d?u, khai m?c
opening	khe h?, l?; s? b?t d?u, s? khai m?c, l? khánh thành
openly	công khai, th?ng th?n
operate	ho?t d?ng, di?u khi?n
operation	s? ho?t d?ng, quá trình ho?t d?ng
opinion	ý ki?n, quan di?m
opponent	d?ch th?, d?i th?, k? thù
opportunity	co h?i, th?i co
oppose	d?i kháng, d?i ch?i, d?i l?p; ch?ng d?i, ph?n d?i
opposed to	ch?ng l?i, ph?n d?i
opposing	tính d?i kháng, d?i ch?i
opposite	d?i nhau, ngu?c nhau; tru?c m?t, d?i di?n; di?u
opposition	s? d?i l?p, s? d?i nhau; s? ch?ng l?i, s? ph?n d?i; phe d?i
option	s? l?a ch?n
orange	qu? cam; có màu da cam
order	th?, b?c; ra l?nh
ordinary	thu?ng, thông thu?ng
organ	dàn óoc gan
organization	t? ch?c, co quan; s? t? ch?c
organize	t? ch?c, thi?t l?p
organized	có tr?t t?, ngan n?p, du?c s?p x?p, du?c t? ch?c
origin	g?c, ngu?n g?c, can nguyên
original	g?c, ngu?n g?c, can nguyên; nguyên b?n
originally	m?t cách sáng t?o, m?i m?, d?c dáo; kh?i d?u, d?u tiên
other	khác
otherwise	khác, cách khác; n?u không thì...; m?t khác
ought to modal	ph?i, nên, h?n là
our	c?a chúng ta, thu?c chúng ta, c?a chúng tôi, c?a chúng mình
ours	c?a chúng ta, thu?c chúng ta, c?a chúng tôi, c?a chúng mình
ourselves	b?n thân chúng ta, b?n thân chúng tôi, b?n thân chúng mình; t? chúng mình
out	ngoài, ? ngoài, ra ngoài
outdoor	ngoài tr?i, ? ngoài
outdoors	? ngoài tr?i, ? ngoài nhà
outer	? phía ngoài, ? xa hon
outline	v?, phác t?o; du?ng nét, hình dáng, nét ngoài
output	s? s?n xu?t; s?n ph?m, s?n lu?ng
outside	b? ngoài, bên ngoài; ? ngoài; ngoài
outstanding	n?i b?t, dáng chú ý; còn t?n l?i
oven	lò
over	bên trên, vu?t qua; lên, lên trên
overall	toàn b?, toàn th?; t?t c?, bao g?m
overcome	th?ng, chi?n th?ng, kh?c ph?c, dánh b?i
owe	n?, hàm on; có du?c
own	c?a chính mình, t? mình; nh?n, nhìn nh?n
owner	ngu?i ch?, ch? nhân
o’clock	dúng gi?
p.m.	quá trua, chi?u, t?i
pace	bu?c chân, bu?c
pack	gói, b?c; bó, gói
package	gói d?, buu ki?n; dóng gói, dóng ki?n
packaging	bao bì
packet	gói nh?
page	trang
pain	s? dau d?n, s? dau kh?
painful	dau d?n, dau kh?
paint	son, vôi màu; son, quét son
painter	h?a si
painting	s? son; b?c h?a, b?c tranh
pair	dôi, c?p
palace	cung di?n, lâu dài
pale	taí, nh?t
pan	xoong, ch?o
panel	ván ô , pa nô
pants	qu?n lót, dùi
paper	gi?y
parallel	song song, tuong duong
parent	cha, m?
park	công viên, vu?n hoa; khoanh vùng thành công viên
parliament	nghi vi?n, qu?c h?i
part	ph?n, b? ph?n
particular	riêng bi?t, cá bi?t
particularly	m?t cách d?c bi?t, cá bi?t, riêng bi?t
partly	d?n ch?ng m?c nào dó, ph?n nào dó
partner	d?i tác, c?ng s?
partnership	s? chung ph?n, s? c?ng tác
party	ti?c, bu?i liên hoan; d?ng
pass	qua, vu?t qua, ngang qua
passage	s? di qua, s? trôi qua; hành lang
passenger	hành khách
passing	s? di qua, s? trôi qua; thoáng qua, ng?n ng?i
passport	h? chi?u
past	quá kh?, di vãng; quá, qua
path	du?ng mòn; hu?ng di
patience	tính kiên nh?n, nh?n n?i, kiên trì, s? ch?u d?ng
patient	b?nh nhân; kiên nh?n, nh?n n?i, b?n chí
pattern	m?u, khuôn m?u
pause	t?m ngh?, d?ng; s? t?m ngh?, s? t?m ng?ng
pay	tr?, thanh toán, n?p; ti?n luong
payment	s? tr? ti?n, s? ti?n tr?, ti?n b?i thu?ng
peace	hòa bình, s? hòa thu?n
peaceful	hòa bình, thái bình, yên tinh
peak	lu?i trai; d?nh, chóp
pen	bút
pence	d?ng xu
pencil	bút chì
penny	s? ti?n
pension	ti?n tr? c?p, luong huu
people	dân t?c, dòng gi?ng; ngu?i
pepper	h?t tiêu, cây ?t
per	cho m?i
per cent	ph?n tram
perfect	hoàn h?o
perfectly	m?t cách hoàn h?o
perform	bi?u di?n; làm, th?c hi?n
performance	s? làm, s? th?c hi?n, s? thi hành, s? bi?u di?n
performer	ngu?i bi?u di?n, ngu?i trình di?n
perhaps	có th?, có l?
period	k?, th?i k?, th?i gian; th?i d?i
permanent	lâu dài, vinh c?u, thu?ng xuyên
permanently	cách thu?ng xuyên, vinh c?u
permission	s? cho phép, gi?y phép
permit	cho phép, cho co h?i
person	con ngu?i, ngu?i
personal	cá nhân, tu, riêng tu
personality	nhân cách, tính cách; nhân ph?m, cá tính
personally	dích thân, b?n thân, v? ph?n rôi, d?i v?i tôi
persuade	thuy?t ph?c
pet	con nóng gi?n; v?t cung, ngu?i du?c yêu thích
petrol	xang d?u
phase	tu?n trang; giai do?n, th?i k?
philosophy	tri?t h?c, tri?t lý
photocopy	b?n sao ch?p; sao ch?p
photograph	?nh, b?c ?nh; ch?p ?nh
photographer	th? ch?p ?nh, nhà nhi?p ?nh
photography	thu?t ch?p ?nh, ngh? nhi?p ?nh
phrase	câu; thành ng?, c?m t?
physical	v?t ch?t;  co th?, thân th?
physically	v? thân th?, theo lu?t t? nhiên
physics	v?t lý h?c
piano	dàn pianô, duong c?m
pick	cu?c
pick sth up	cu?c, v?, xé
picture	b?c v?, b?c h?a
piece	m?nh, m?u; d?ng ti?n
pig	con l?n
pile	c?c, ch?ng, d?ng, pin; dóng c?c, ch?t ch?ng
pill	viên thu?c
pilot	phi công
pin	dinh ghim; ghim., k?p
pink	màu h?ng; hoa c?m chu?ng, tình tr?ng t?t, hoàn h?o
pint	panh
pipe	?ng d?n
pitch	sân ; d?u h?c ín
pity	lòng thuong h?i, di?u dáng ti?c, dáng thuong
place	noi, d?a di?m; qu?ng tru?ng
plain	ngay th?ng, don gi?n, ch?t phác
plan	b?n d?, k? ho?ch; v? b?n d?, l?p k? ho?ch, d? ki?n
plane	m?t ph?ng, m?t b?ng
planet	hành tinh
planning	s? l?p k? ho?ch, s? quy ho?ch
plant	th?c v?t, s? m?c lên; tr?ng, gieo
plastic	ch?t d?o, làm b?ng ch?t d?o
plate	b?n, t?m kim lo?i
platform	n?n, b?c, b?; th?m, sân ga
play	choi, dánh; s? vui choi, trò choi, tr?n d?u
player	ngu?i choi 1 trò choi nào dó
pleasant	vui v?, d? thuong; d?u dàng, thân m?t
pleasantly	vui v?, d? thuong; thân m?t
please exclamation,	làm vui lòng, v?a lòng, mong... vui lòng, xin m?i
pleased	hài lòng
pleasing	mang l?i ni?m vui thích; d? ch?u
pleasure	ni?m vui thích, di?u thích thú, di?u thú v?; ý mu?n, ý thích
plenty	nhi?u ; ch? s? th?a; s? sung túc, s? p.phú
plot	m?nh d?t nh?, so d?, d? th?, d? án; v? so d?, d?ng d? án
plug	nút
plus	c?ng v?i ; d?u c?ng; c?ng, thêm vào
pocket	túi , túi ti?n
poem	thi ca; ch?t tho
point	mui nh?n, di?m; vót, làm nh?n, ch?m
pointed	nh?n, có d?u nh?n
poison	ch?t d?c, thu?c d?c; dánh thu?c d?c, t?m thu?c d?c
poisonous	d?c, có ch?t d?c, gây ch?t, b?nh
pole	ngu?i ba lan; c?c
police	c?nh sát, công an
policy	chính sách
polish	nu?c bóng, nu?c láng; dánh bóng, làm cho láng
polite	l? phép, l?ch s?
politely	l? phép, l?ch s?
political	v? chính tr?, v? chính ph?, có tính chính tr?
politically	v? m?t chính tr?; khôn ngoan, th?n tr?ng; s?o quy?t
politician	nhà chính tr?, chính khách
politics	h?at d?ng chính tr?, d?i s?ng chính tr?, quan di?m chính tr?
pollution	s? ô nhi?m
pool	vung nu?c; b? boi, h? boi
poor	nghèo
pop	ti?p b?p, phong cách dân gian hi?n d?i; n? b?p
popular	có tính d?i chúng,  nhân dân; du?c nhi?u ngu?i ua chu?ng
population	dân cu, dân s?; m?t d? dân s?
port	c?ng
pose	dua ra, d? ra, d?t; s? d?t, d? ra
position	v? trí, ch?
positive	xác th?c, rõ ràng, tích c?c, l?c quan
possess	có, chi?m h?u
possession	quy?n s? h?u, v?t s? h?u
possibility	kha nang, tri?n v?ng
possible	có th?, có th? th?c hi?n
possibly	có l?, có th?, có th? ch?p nh?n du?c
post	thu, buu ki?n; g?i thu
post office	buu di?n
pot	can, bình, l?...
potato	khoai tây
potential	ti?m nang; kh? nang, ti?m l?c
potentially	ti?m nang, ti?m ?n
pound	pao - don v? do lu?ng
pour	rót, d?, gi?i
powder	b?t, b?i
power	kh? nang, tài nang, nang l?c; s?c m?nh, n?i l?c; quy?n l?c
powerful	hùng m?nh, hùng cu?ng
practical	th?c hành; th?c t?
practically	v? m?t th?c hành; th?c t?
practice	th?c hành, th?c ti?n
practise	th?c hành, t?p luy?n
praise	s? ca ng?i, s? tán duong, lòng tôn kính, tôn th?; khen ng?i, tán duong
prayer	s? c?u nguy?n
precise	rõ ràng, chính xác; t? m?, k? tính
precisely	dúng, chính xác, c?n th?n
predict	báo tru?c, tiên doán, d? báo
prefer	thích hon
preference	s? thích hon, s? ua hon; cái du?c ua thích hon
pregnant	mang thai; giàu trí tu?ng tu?ng, sáng t?o
premises	bi?t th?
preparation	s? s?a so?n, s? chu?n b?
prepare	s?a so?n, chu?n b?
prepared	dã du?c chu?n b?
presence	s? hi?n di?n, s? có m?t; ngu?i, vât hi?n di?n
present	có m?t, hi?n di?n; hi?n nay, hi?n th?i; bày t?, gi?i thi?u, trình bày
presentation	bài thuy?t trình, s? trình di?n, s? gi?i thi?u
preserve	b?o qu?n, gi? gìn
president	hi?u tru?ng, ch? t?nh, t?ng th?ng
press	s? ép, s? nén, s? ?n; ép, nén, bóp, ?n
pressure	s?c ép, áp l?c, áp su?t
presumably	có th? du?c, có l?
pretend	gi? v?, gi? b?, làm ra v?
pretty	khá, v?a ph?i; xinh, xinh x?n;, d?p
prevent	ngan c?n, ngan ch?n, ngan ng?a
previous	v?i vàng, h?p t?p; tru?c , uu tiên
previously	tru?c, tru?c dây
price	s? kiêu hãnh, s? hãnh di?n; tính kiêu cang, t? ph?
priest	linh m?c, th?y tu
primarily	tru?c h?t, d?u tiên
primary	nguyên th?y, d?u tiên; th?i c? d?i, nguyên sinh; so c?p, ti?u h?c
prime minister	th? tu?ng
prince	hoành t?
princess	công chúa
principle	co b?n, ch? y?u; nguyên lý, nguyên t?c
print	in, xu?t b?n; s? in ra
printer	máy in, th? in
printing	s? in, thu?t in, k? s?o in
prior	tru?c, uu tiên
priority	s? uu t?, quy?n uu tiên
prison	nhà tù
prisoner	tù nhân
private	cá nhân, riêng
privately	riêng tu, cá nhân
prize	gi?i, gi?i thu?ng
probable	có th?, có kh? nang
probably	h?u nhu ch?c ch?n
problem	v?n d?, di?u khó gi?i quy?t
procedure	th? t?c
proceed	ti?n lên, theo du?i, ti?p di?n
process	quá trình, s? ti?n tri?n, quy trình; ch? bi?n, gia công, x? lý
produce	s?n xu?t, ch? t?o
producer	nhà s?n xu?t
product	s?n ph?m
production	s? s?n xu?t, ch? t?o
profession	ngh?, ngh? nghi?p
professional	ngh?, ngh? nghi?p; chuyên nghi?p
professor	giáo su, gi?ng viên
profit	thu?n l?i, l?i ích, l?i nhu?n
program	chuong trình; lên chuong trình
programme	chuong trình
progress	s? ti?n t?i, s? ti?n tri?n; ti?n b?, ti?n tri?n, phát tri?n
project	d? án, d? án, k? ho?ch; d? ki?n, k? ho?ch
promise	h?a, l?i h?a
promote	thang ch?c, thang c?p
promotion	s? thang ch?c, s? thang c?p
prompt	mau l?, nhanh chóng; xúi, gi?c, nh?c nh?
promptly	mau l?, ngay l?p t?c
pronounce	tuyên b?, thông báo, phát âm
pronunciation	s? phát âm
proof	ch?ng, ch?ng c?, b?ng ch?ng; s? ki?m ch?ng
proper	dúng, thích dáng, thích h?p
properly	m?t cách dúng d?n, m?t cách thích dáng
property	tài s?n, c?a c?i; d?t dai, nhà c?a, b?t d?ng s?n
proportion	s? cân x?ng, s? cân d?i
proposal	s? d? ngh?, d? xu?t
propose	d? ngh?, d? xu?t, dua ra
prospect	vi?n c?nh, toàn c?nh; tri?n v?ng, mong ch?
protect	b?o v?, che ch?
protection	s? b?o v?, s? che ch?
protest	s? ph?n d?i, s? ph?n kháng; ph?n d?i, ph?n kháng
proud	t? hào, kiêu hãnh
proudly	m?t cách t? hào, m?t cách hãnh di?n
prove	ch?ng t?, ch?ng minh
provide	chu?n b? d?y d?, d? phòng; cung c?p, chu c?p
provided	v?i di?u ki?n là, mi?n là
public	chung, công c?ng; công chúng, nhân dân
publication	s? công b?; s? xu?t b?n
publicity	s? công khai, s? qu?ng cáo
publicly	công khai, công c?ng
publicyhouse	quán ru?u, ti?m ru?u
publish	công b?, ban b?; xu?t b?n
publishing	công vi?c, ngh? xu?t b?n
pull	lôi, kéo, gi?t; s? lôi kéo, s? gi?t
punch	d?m, th?i; qu? d?m, cú th?i
punish	ph?t, tr?ng ph?t
punishment	s? tr?ng ph?t, s? tr?ng tr?
pupil	h?c sinh
purchase	s? mua, s? t?u; mua, s?m, t?u
pure	nguyên ch?t, tinh khi?t, trong lành
purely	hoàn toàn, ch? là
purple	tía, có màu tía; màu tía
purpose	m?c dích, ý d?nh
pursue	du?i theo, du?i b?t
push	xô d?y; s? xô d?y
put	d?t, d?, cho vào
put  out	t?t, d?p t?t
qualification	ph?m ch?t, nang l?c; kh? nang chuyên môn
qualified	d? tu cách, di?u ki?n, kh? nang
qualify	d? kh? nang, d? tu cách, di?u ki?n
quality	ch?t lu?ng, ph?m ch?t
quantity	lu?ng, s? lu?ng
quarter	4, 15 phút
queen	n? hoàng
question	câu h?i; h?i, ch?t v?n
quick	nhanh
quickly	nhanh
quiet	l?ng, yên l?ng, yên tinh
quietly	l?ng, yên l?ng, yên tinh
quit	thoát, thoát ra
quite	hoàn toàn, h?u h?t
quote	trích d?n
race	loài, ch?ng, gi?ng; cu?c dua; dua
racing	cu?c dua
radio	sóng vô tuy?n, radio
rail	du?ng ray
railway	du?ng s?t
rain	mua, con mua; mua
raise	nâng lên, dua lên, ng?ng lên
range	dãy, hàng, lo?i; ph?m vi, trình d?
rank	hàng, dãy; s?p x?p thành hàng, dãy
rapid	nhanh, nhanh chóng
rapidly	nhanh, nhanh chóng
rare	hi?m, ít
rarely	hi?m khi, ít khi
rate	t? l?, t?c d?
rather	thà.. còn hon, thích... hon
rather than	hon là
raw	s?ng , thô, còn nguyên ch?t
reach	d?n, di d?n, t?i
react	tác d?ng tr? l?i, ph?n ?ng
reaction	s? ph?n ?ng; s? ph?n tác d?ng
read	d?c
reader	ngu?i d?c, d?c gi?
reading	s? d?c
ready	s?n sàng
real	th?c, th?c t?, có th?t
realistic	hi?n th?c
reality	s? th?t, th?c t?, th?c t?i
realize	th?c hi?n, th?c hành
really	th?c, th?c ra, th?c s?
rear	phía sau; ? d?ng sau, ? d?ng sau
reason	lý do, lý l?
reasonable	có lý, h?p lý
reasonably	h?p lý
recall	g?i v?, tri?u h?i; nh?c l?i, g?i l?i
receipt	công th?c; don thu?c
receive	nh?n, linh, thu
recent	g?n dây, m?i dây
recently	g?n dây, m?i dây
reception	s? nh?n, s? ti?p nh?n, s? dón ti?p
reckon	tính, d?m
recognition	s? công nh?n, s? th?a nh?n
recognize	nh?n ra, nh?n di?n; công nh?n, th?a nh?n
recommend	gi?i thi?u, ti?n c?; d? ngh?, khuyên b?o
record	b?n ghi, s? ghi, b?n thu, s? thu; thu, ghi chép
recording	s? ghi, s? thu âm
recover	l?y l?i, giành l?i
red	d?; màu d?
reduce	gi?m, gi?m b?t
reduction	s? gi?m giá, s? h? giá
refer to	xem, tham kh?o; ám ch?, nh?c d?n
reference	s? tham kh?o, h?i ýe ki?n
reflect	ph?n chi?u, ph?n h?i, ph?n ánh
reform	c?i cách, c?i thi?n, c?i t?o; s? c?i cách, s? c?i thi?n, c?i t?o
refrigerator	t? l?nh
refusal	s? t? ch?i, s? khu?c t?
refuse	t? ch?i, khu?c t?
regard	nhìn, dánh giá; cái nhìn, s? quan tâm, s? chú ý
regarding	v?, v? vi?c, d?i v?i
region	vùng, mi?n
regional	vùng, d?a phuong
register	dang ký, ghi vào s?; s?, s? sách, máy ghi
regret	dáng ti?c, h?i ti?c; lòng thuong ti?c, s? h?i ti?c
regular	thu?ng xuyên, d?u d?n
regularly	d?u d?n, thu?ng xuyên
regulation	s? di?u ch?nh, di?u l?, quy t?c
reject	không ch?p nh?n, lo?i b?, bác b?
relate	k? l?i, thu?t l?i; liên h?, liên quan
related	có liên quan, có quan h? v?i ai, cái gì
relation	m?i quan h?, s? liên quan, liên l?c
relationship	m?i quan h?, m?i liên l?c
relative	có liên quan d?n; ngu?i có h?, d?i t? quan h?
relatively	có liên quan, có quan h?
relax	gi?i trí, ngh? ngoi
relaxed	thanh th?n, tho?i mái
relaxing	làm gi?m, b?t cang th?ng
release	làm nh?, b?t, th?, phóng thích, phát hành; s? gi?i thoát, thoát
relevant	thích h?p, có liên quan
relief	s? gi?m nh?, s? làm cho khuây kh?a; s? tr? c?o; s? d?n bù
religion	tôn giáo
religious	tôn giáo
rely on	tin vào, tin c?y, tin tu?ng vào
remain	còn l?i, v?n còn nhu cu
remaining	còn l?i
remains	d? th?a, cái còn l?i
remark	s? nh?n xét, phê bình, s? d? ý, chú ý; nh?n xét, phê bình, d? ý, chú ý
remarkable	dáng chú ý, dáng d? ý; khác thu?ng
remarkably	dáng chú ý, dáng d? ý; khác thu?ng
remember	nh?, nh? l?i
remind	nh?c nh?, g?i nh?
remote	xa, xa xôi, xa cách
removal	viêc di chuy?n, vi?c d?n nhà, d?i di
remove	d?i di, di chuy?n
rent	s? thuê mu?n; cho thuê, thuê
rented	du?c thuê, du?c mu?n
repair	s?a ch?a, ch?nh tu; s? s?a ch?a, s? ch?nh tu
repeat	nh?c l?i, l?p l?i
repeated	du?c nh?c l?i, du?c l?p l?i
repeatedly	l?p di l?p l?i nhi?u l?n
replace	thay th?
reply	s? tr? l?i, s? h?i âm; tr? l?i, h?i âm
report	báo cáo, tu?ng trình; b?n báo cáo, b?n tu?ng trình
represent	miêu t?, hình dung; d?i di?n, thay m?t
representative	di?u tiêu bi?u, tu?ng trung, m?u; miêu t?, bi?u hi?n, d?i di?n, tu?ng trung
reproduce	tái s?n xu?t
reputation	s? n?i ti?ng, n?i danh
request	l?i th?nh c?u, l?i d? ngh?, yêu c?u; th?nh c?u, d? ngh?, yêu c?u
require	dòi h?i, yêu c?u, quy d?nh
requirement	nhu c?u, s? dòi h?i; lu?t l?, th? t?c
rescue	gi?i thoát, c?u nguy; s? gi?i thoát, s? c?u nguy
research	s? nghiên c?u
reservation	s? h?n ch?, di?u ki?n h?n ch?
reserve	d? tr?, d? dành, d?t tru?c, dang ký tru?c; s? d? tr?, s? d? dành, s? d?t tru?c, s? dang ký tru?c
resident	ngu?i sinh s?ng, trú ng?, khách tr?; có nhà ?, cu trú, thu?ng trú
resist	ch?ng l?i, ph?n d?i, kháng c?
resistance	s? ch?ng l?i, s? ph?n d?i, s? kháng c?
resolve	quy?t d?nh, kiên quy?t
resort	k? sách, phuong k?
resource	tài nguyên; k? sách, th? do?n
respect	s? kính tr?ng, s? l? phép; tôn tr?ng, kính tr?ng, khâm ph?c
respond	hu?ng ?ng, ph?n ?ng l?i, tr? l?i
response	s? tr? l?i, câu tr? l?i, s? hu?ng ?ng, s? dáp l?i
responsibility	trách nhi?m, s? ch?u trách nhi?m
responsible	ch?u trách nhi?m v?, ch?u trách nhi?m tru?c ai, gì
rest	s? ngh? ngoi, lúc ngh?; ngh?, ngh? ngoi
restaurant	nhà hàng an, hi?u an
restore	hoàn l?i, tr? l?i; s?a ch?a l?i, ph?c h?i l?i
restrict	h?n ch?, gi?i h?n
restricted	b? h?n ch?, có gi?i h?n; vùng c?m
restriction	s? h?n ch?, s? gi?i h?n
result	k?t qu?; b?i, do.. mà ra, k?t qu? là...
retain	gi? l?i, nh? du?c
retire	r?i b?, rút v?; thôi, ngh? vi?c, v? huu
retired	?n d?t, h?o lánh, dã v? huu, dã ngh? vi?c
retirement	s? ?n d?t, noi h?o lánh, s? v? huu, s? ngh? vi?c
return	tr? l?i, tr? v?; s? tr? l?i, s? tr? v?
reveal	b?c l?, bi?u l?, ti?t l?; phát hi?n, khám phá
reverse	d?o, ngu?c l?i; di?u trái ngu?c, m?t trái
review	s? xem l?i, s? xét l?i; làm l?i, xem xét l?i
revise	d?c l?i, xem l?i, s?a l?i, ôn l?i
revision	s? xem l?i, s? d?c l?i, s? s?a l?i, s? ôn l?i
revolution	cu?c cách m?ng
reward	s? thu?ng, ph?n thu?ng; thu?ng, thu?ng công
rhythm	nh?p di?u
rice	g?o, thóc, com; cây lúa
rich	giàu, giàu có
rid	gi?i thoát
ride	di, cu?i ; s? di, du?ng di
rider	ngu?i cu?i ng?a, ngu?i di xe d?p
ridiculous	bu?n cu?i, l? b?ch, l? lang
riding	môn th? thao cu?i ng?a, s? di xe
right	th?ng, ph?i, t?t; ngay, dúng; di?u thi?n, di?u ph?i, t?t, bên ph?i
rightly	dúng, ph?i, có lý
ring	chi?c nh?n, deo nh?n cho ai
rise	s? lên, s? tang luong, thang c?p; d?y, d?ng lên, m?c , thành d?t
risk	s? li?u, m?o hi?m; li?u
rival	d?i th?, d?ch th?; d?i d?ch, c?nh tranh
river	sông
road	con du?ng, du?ng ph?
rob	cu?p, l?y tr?m
rock	dá
role	vai , vai trò
roll	cu?n, cu?n, s? lan tròn; lan, cu?n, qu?n, cu?n
romantic	lãng m?n
roof	mái nhà, nóc
room	phòng, bu?ng
root	g?c, r?
rope	dây cáp, dây th?ng, xâu, chu?i
rough	g? gh?, l?m ch?m
roughly	g? gh?, l?m ch?m
round	tròn, vòng quanh, xung quanh
rounded	b? làm thành tròn; phát tri?n d?y d?
route	du?ng di, l? trình, tuy?n du?ng
routine	thói thu?ng, l? thu?ng, th? t?c; thu?ng l?, thông thu?ng
row name	hàng, dãy
royal	vua, n? hoàng, hoàng gia
rub	c? xát, xoa bóp, nghi?n, tán
rubber	cao su
rubbish	v?t vô giá tr?, b? di, rác ru?i
rude	b?t l?ch s?, thô l?; thô so, don gi?n
rudely	b?t l?ch s?, thô l?; thô so, don gi?n
ruin	làm h?ng, làm d? nát, làm phá s?n; s? h?ng, s? d? nát, s? phá s?n
ruined	b? h?ng, b? d? nát, b? phá s?n
rule	quy t?c, di?u l?, lu?t l?; cai tr?, ch? huy, di?u khi?n
ruler	ngu?i cai tr?, ngu?i tr? vì; thu?c k?
rumour	tin d?n, l?i d?n
run	ch?y; s? ch?y
runner	ngu?i ch?y
running	s? ch?y, cu?c ch?y dua
rural	nông thôn, vùng nông thôn
rush	xông lên, lao vào, xô d?y; s? xông lên, s? lao vào, s? xô d?y
sack	bào t?i; dóng bao, b? vào bao
sad	bu?n, bu?n bã
sadly	m?t cách bu?n bã, dáng bu?n là, không may mà
sadness	s? bu?n r?u, s? bu?n bã
safe	an toàn, ch?c ch?n, dáng tin
safely	an toàn, ch?c ch?n, dáng tin
safety	s? an toàn, s? ch?c chan
sail	di tàu, thuy?n, nh? neo; bu?m, cánh bu?m, chuy?n di b?ng thuy?n bu?m
sailing	s? di thuy?n
sailor	th?y th?
salad	sa lát ; rau s?ng
salary	ti?n luong
sale	vi?c bán hàng
salt	mu?i
salty	ch? v? mu?i, có mu?i, m?n
same	d?u d?u, don di?u; cung nhu th?, v?n cái dó
sample	m?u, hàng m?u
sand	cát
satisfaction	s? làm cho th?a mãn, to?i nguy?n; s? tr? n?, b?i thu?ng
satisfied	c?m th?y hài lòng, v?a ý, tho? mãn
satisfy	làm th?a mãn, hài lòng; tr? , chu?c t?i
satisfying	dem l?i s? th?a mãn, làm th?a mãn, làm v?a ý
saturday	th? 7
sauce	nu?c x?t, nu?c ch?m
save	c?u, luu
saving	nói
scale	v?y
scare	làm kinh hãi, s? hãi, d?a; s? s? hãi, s? kinh hoàng
scared	b? ho?ng s?, b? s? hãi
scene	c?nh, phong c?nh
schedule	k? ho?ch làm vi?c, b?n li?t kê; lên th?i khóa bi?u, lên k? ho?ch
scheme	s? s?p x?p, s? ph?i h?p; k? ho?ch th?c hi?n; lu?c d?, so d?
school	dàn cá, b?y cá
science	khoa h?c, khoa h?c t? nhiên
scientific	khoa h?c, có tính khoa h?c
scientist	nhà khoa h?c
scissors	cái kéo
score	di?m s?, b?n th?ng, t? s?; d?t du?c, thành công, cho di?m
scratch	cào, làm xu?c da; s? cào, s? tr?y xu?c da
scream	gào thét, kêu lên; ti?ng thét, ti?ng kêu to
screen	màn che, màn ?nh, màn hình; phim ?nh nói chung
screw	dinh vít, dinh ?c; b?t vít, b?t ?c
sea	bi?n
seal	h?i c?u; san h?i c?u
search	s? tìm ki?m, s? tham dò, s? di?u tra; tìm ki?m, tham dò, di?u tra
season	mùa
seat	gh?, ch? ng?i
second	th? hai, ? v? trí th? 2, th? nhì; ngu?i v? nhì
secondary	trung h?c, th? y?u
secret	bí m?t; di?u bí m?t
secretary	thu ký
secretly	bí m?t, riêng tu
section	m?c, ph?n
sector	khu v?c, linh v?c
secure	ch?c ch?n, d?m b?o; b?o d?m, gi? an ninh
security	s? an toàn, s? an ninh
see	nhìn, nhìn th?y, quan sát
seed	h?t, h?t gi?ng
seek	tìm, tìm ki?m, theo du?i
seem linking	ch?n l?a, ch?n l?c
selection	s? l?a ch?n, s? ch?c l?c
self	b?n thân mình
sell	bán
senate	thu?ng nghi vi?n, ban giám hi?u
senator	thu?ng ngh? si
send	g?i, phái di
senior	nhi?u tu?i hon, dành cho tr? em trên 11t; ngu?i l?n tu?i hon, sinh viên nam cu?i tru?ng trung h?c, cao d?ng
sense	giác quan, tri giác, c?m giác
sensible	có óc xét doán; hi?u, nh?n bi?t du?c
sensitive	d? b? thuong, d? b? h?ng; d? b? xúc ph?m
sentence	câu
separate	khác nhau, riêng bi?t; làm r?i, tách ra, chia tay
separated	ly thân
separately	không cùng nhau, thành ngu?i riêng, v?t riêng
separation	s? chia c?t, phân ly, s? chia tay, ly thân
september	tháng 9
series	lo?t, dãy, chu?i
serious	d?ng d?n, nghiêm trang
seriously	d?ng d?n, nghiêm trang
servant	ngu?i h?u, d?y t?
serve	ph?c v?, ph?ng s?
service	s? ph?c v?, s? h?u h?
session	bu?i h?p, phiên h?p, bu?i, phiên
set	b?, b?n, dám, lu; d?t d?, b? trí
set fire to	d?t cháy cái gì
settle	gi?i quy?t, dàn x?p, hòa gi?i, d?t, b? trí
several	vài
severe	kh?t khe, gay g?t
severely	kh?t khe, gay g?t
sew	may, khâu
sewing	s? khâu, s? may vá
sex	gi?i, gi?ng
sexual	gi?i tính, các v?n d? sinh lý
sexually	gi?i tính, các v?n d? sinh lý
shade	bóng, bóng t?i
shadow	bóng, bóng t?i, bóng râm, bóng mát
shake	rung, l?c, giu; s? rung, s? l?c, s? giu
shall modal	d? doán tuong lai: s?
shallow	nông, c?n
shame	s? x?u h?, th?n thùng, s? ngu?ng
shape	hình, hình d?ng, hình thù
shaped	có hình dáng du?c ch? rõ
share	dóng góp, tham gia, chia s?; ph?n dóng góp, ph?n tham gia, ph?n chia s?
sharp	s?c, nh?n, bén
sharply	s?c, nh?n, bén
shave	c?o
she	nó, bà ?y, ch? ?y, cô ?y...
sheep	con c?u
sheet	chan, khan tr?i giu?ng; lá, t?m, phi?n, t?
shelf	k?, ngan, giá
shell	v?, mai; v? b? ngoài
shelter	s? nuong t?a, s? che ch?, s? ?n náu; che ch?, b?o v?
shift	d?i ch?, d?i ch?, chuy?n, giao; s? thay d?i, s? luân phiên
shine	chi?u sáng, t?a sáng
shiny	sáng chói, bóng
ship	tàu, tàu th?y
shirt	áo so mi
shock	s? d?ng ch?m, va ch?m, s? kích d?ng, s? choáng; ch?m m?nh, va m?nh, gây s?c
shocked	b? kích d?ng, b? va ch?m, b? s?c
shocking	gây ra cam ph?n, t?i t?, gây kích d?ng
shoe	giày
shoot	v?t qua, ch?y qua, ném, phóng, b?n; dâm ra, tr?i ra
shooting	s? b?n, s? phóng di
shop	c?a hàng; di mua h?ng, di ch?
shopping	s? mua s?m
short	ng?n, c?t
shortly	trong th?i gian ng?n, s?m
shot	d?n, viên d?n
should modal	nên
shoulder	vai
shout	hò hét, reo hò; s? la hét, s? hò reo
show	bi?u di?n, trung bày; s? bi?u di?n, s? bày t?
shower	vòi hoa sen, s? t?m vòi hoa sen
shut	dóng, khép, d?y; tính khép kín
shy	nhút nhát, e th?n
sick	?m, dau, b?nh
side	m?t, m?t ph?ng
sideways	ngang, t? m?t bên; sang bên
sight	c?nh d?p; s? nhìn
sign	d?u, d?u hi?u, kí hi?u; dánh d?u, vi?t ký hi?u
signal	d?u hi?u, tín hi?u; ra hi?u, báo hi?u
signature	ch? ký
significant	nhi?u ý nghia, quan tr?ng
significantly	dáng k?
silence	s? im l?ng, s? yên tinh
silent	im l?ng, yên tinh
silk	to , ch?, l?a
silly	ng? ng?n, ngu ng?c, kh? d?i
silver	b?c, d?ng b?c; làm b?ng b?c, tr?ng nhu b?c
similar	gi?ng nhu, tuong t? nhu
similarly	tuong t?, gi?ng nhau
simple	don, don gi?n, d? dàng
simply	m?t cách d? dàng, gi?n d?
since	t?, t? khi; t? khi, t? lúc dó; t? dó, t? lúc ?y
sincere	th?t thà, th?ng th?ng, chân thành
sincerely	m?t cách chân thành
sing	hát, ca hát
singer	ca si
singing	s? hát, ti?ng hát
single	don, don d?c, don l?
sink	chìm, lún, d?m
sir	xung hô l?ch s? ngài, ông
sister	ch?, em gái
sit	ng?i
sit down	ng?i xu?ng
site	ch?, v? trí
situation	hoàn c?nh, d?a th?, v? trí
size	c?
sized	dã du?c d?nh c?
skilful	tài gi?i, khéo tay
skilfully	tài gi?i, khéo tay
skill	k? nang, k? s?o
skilled	có k? nang, có k? s?o, kh?o tay; có kinh nghi?m,, lành ngh?
skin	da, v?
skirt	váy, d?m
sky	tr?i, b?u tr?i
sleep	ng?; gi?c ng?
sleeve	tay áo, ?ng tay
slice	mi?ng, lát m?ng; c?t ra thành mi?ng m?ng, lát m?ng
slide	tru?tc, chuy?n d?ng nh?, lu?t qua
slight	m?ng manh, thon, g?y
slightly	m?nh kh?nh, m?ng manh, y?u ?t
slip	tru?t, tu?t, trôi qua, ch?y qua
slope	d?c, du?ng d?c, d? d?c; nghiêng, d?c
slow	ch?m, ch?m ch?p
slowly	m?t cách ch?m ch?p, ch?m d?n
small	nh?, bé
smart	m?nh, ác li?t
smash	d?p, v? tan thành m?nh; s? d?p, v? tàn thành m?nh
smell	ng?i; s? ng?i, kh?u giác
smile	cu?i, m?m cu?i; n? cu?i, v? tuoi cu?i
smoke	khói, hoi thu?c; hút thu?c, b?c khói, hoi
smoking	s? hút thu?c
smooth	nh?n, tron, mu?t mà
smoothly	m?t cách êm ?, trôi ch?y
snake	con r?n; ngu?i nham hi?m, x?o trá
snow	tuy?t; tuy?t roi
so	nhu v?y, nhu th?; vì th?, vì v?y, vì th? cho nên
so that	d?, d? cho, d? mà
soap	xà phòng
social	có tính xã h?i
socially	có tính xã h?i
society	xã h?i
sock	t?t ngans, mi?ng lót giày
soft	m?m, d?o
softly	m?t cách m?m d?o
software	ph?n m?m
soil	d?t tr?ng; v?t b?n
soldier	lính, quân nhân
solid	r?n; th? r?n, ch?t r?nh
solution	s? gi?i quy?t, gi?i pháp
solve	gi?i, gi?i thích, gi?i quy?t
some	m?t it, m?t vài
somebody	ngu?i nào dó
somehow	không bi?t làm sao, b?ng cách này hay cách khác
something	m?t di?u gì dó, m?t vi?c gì dó, m?t cái gì dó
sometimes	th?nh tho?ng, dôi khi
somewhat	d?n m?c d? nào dó, hoi, m?t chút
somewhere	noi nào dó. dâu dó
son	con trai
song	bài hát
soon	s?m, ch?ng bao lâu n?a
sore	dau, nh?c
sorry	xin l?i, l?y làm ti?c, l?y làm bu?n
sort	th?, h?ng lo?i; l?a ch?n, s?p x?p, phân lo?i
soul	tâm h?n, tâm trí, linh h?n
sound	âm thanh; nghe
soup	xúp, canh, cháo
sour	chua, có v? gi?m
source	ngu?n
south	phuong nam, hu?ng nam; ? phía nam; hu?ng v? phía nam
southern	thu?c phuong nam
space	kho?ng tr?ng, kho?ng cách
spare	th?a thãi, d? tr?, r?ng rãi; d? d? tr?, d? d? phòng
speak	nói
speaker	ngu?i nói, ngu?i di?n thuy?t
special	d?c bi?t, riêng bi?t
specialist	chuyên gia, chuyên viên
specially	d?c bi?t, riêng bi?t
specific	d?c trung, riêng bi?t
specifically	d?c trung, riêng bi?t
speech	s? nói, kh? nang nói, l?i nói, cách nói, bài nói
speed	t?c d?, v?n t?c
spell	dánh v?n; s? thu hút, s? quy?n ru, say mê
spelling	s? vi?t chính t?
spend	tiêu, xài
spice	gia v?
spicy	có gia v?
spider	con nh?n
spin	quay, quay tròn
spirit	tinh th?n, tâm h?n, linh h?n
spiritual	tinh th?n, linh h?n
spite	s? gi?n, s? h?n thù;
split	ch?, tách, chia ra; s? ch?, s? tách, s? chia ra
spoil	cu?p, cu?p d?at
spoken	nói theo 1 cách nào dó
spoon	cái thìa
sport	th? thao
spot	d?u, d?m, v?t
spray	máy, ?ng, bình ph?t, bom, phun; bom, phun, x?t
spread	tr?i, cang ra, bày ra; truy?n bá
spring	mùa xuân
square	vuông, vuông v?n; d?ng hình vuông, hình vuông
squeeze	ép, v?t, xi?t; s? ép, s? v?t, s? xi?t
stable	?n d?nh, bình tinh, v?ng vàng; chu?ng ngua
staff	g?y
stage	t?ng, b?
stair	b?c thang
stamp	tem; dán tem
stand	d?ng, s? d?ng
stand up	d?ng d?y
standard	tiêu chu?n, chu?n, mãu; làm tiêu chu?n, phù h?p v?i tiêu chu?n
star	ngôi sao, dán sao, trang trí hình sao, dánh d?u sao
stare	nhìm ch?m ch?m; s? nhìn ch?m ch?m
start	b?t d?u, kh?i d?ng; s? b?t d?u, s? kh?i d?u, kh?i hành
state	nhà nu?c, qu?c gia, chính quy?n;  nhà nu?c, có liên quan d?n nhà nu?c; phát bi?u, tuyên b?
statement	s? bày t?, s? phát bi?u; s? tuyên b?, s? trình bày
station	tr?m, di?m, d?n
statue	tu?ng
status	tình tr?ng
stay	? l?i, luu l?i; s? ? l?i, s? luu l?i
steadily	v?ng ch?c, v?ng vàng, kiên d?nh
steady	v?ng ch?c, v?ng vàng, ki?n d?nh
steal	an c?p, an tr?m
steam	hoi nu?c
steel	thép, ngành thép
steep	d?c, d?c d?ng
steeply	d?c, cheo leo
steer	lái
step	bu?c; bu?c, bu?c di
stick	dâm, th?c, ch?c, c?m, dính; cái g?y, qua c?i, cán
stick out	dòi, d?t du?c cái gì
sticky	dính, nh?t
stiff	c?ng, c?ng r?n, kiên quy?t
stiffly	c?ng, c?ng r?n, kiên quy?t
still	d?ng yên; v?n, v?n còn
sting	châm, chích, d?t; ngòi, vòi ; s? châm, chích..
stir	khu?y, d?o
stock	kho s? tr?, hàng d? tr?, v?n
stomach	d? dày
stone	dá
stop	d?ng, ng?ng, ngh?, thôi; s? d?ng, s? ng?ng, s? d? l?i
store	c?a hàng, kho hàng; tích tr?, cho vào kho
storm	con giông, bão
story	chuy?n, câu chuy?n
stove	b?p lò, lò su?i
straight	th?ng, không cong
strain	s? cang th?ng, s? cang
strange	xa l?, chua quen
strangely	l?, xa l?, chua quen
stranger	ngu?i l?
strategy	chi?n lu?c
stream	dòng su?i
street	ph?, du?mg ph?
strength	s?c m?nh, s?c kh?e
stress	s? cang th?ng; cang th?ng, ép, làm cang
stressed	b? cang th?ng, b? ép, b? cang
stretch	cang ra, du?i ra, kéo dài ra
strict	nghiêm kh?c, ch?t ch?,, kh?t khe
strictly	m?t cách nghiêm kh?c
strike	dánh, d?p, bãi công, dình công; cu?c bãi công, cu?c dình công
striking	n?i b?t, gây ?n tu?ng
string	dây, s?i dây
strip	c?i, l?t ; s? c?i qu?n áo
stripe	s?c, v?n, vi?n
striped	có s?c, có v?n
stroke	cú dánh, cú dòn; cái vu?t ve, s? vu?t ve; vu?t ve
strong	kh?e, m?nh, b?n, v?ng, ch?c ch?n
strongly	kh?e, ch?c ch?n
structure	k?t c?u, c?u trúc
struggle	d?u tranh; cu?c d?u tranh, cu?c chi?n d?u
student	sinh viên
studio	xu?ng phim, tru?ng quay; phòng thu
study	s? h?c t?p, s? nghiên c?u; h?c t?p, nghiên c?u
stuff	ch?t li?u, ch?t
stupid	ngu ng?c, ngu d?n, ng? ng?n
style	phong cách, ki?u, m?u, lo?i
subject	ch? d?, d? tài; ch? ng?
substance	ch?t li?u; b?n ch?t; n?i dung
substantial	th?c t?, dáng k?, quan tr?ng
substantially	v? th?c ch?t, v? can b?n
substitute	ngu?i, v?t thay th?; thay th?
succeed	n?i ti?p, k? ti?p; k? nghi?p, k? v?
success	s? thành công,, s? thành d?t
successful	thành công, th?ng l?i, thành d?t
successfully	thành công, th?ng l?i, thành d?t
such	nhu th?, nhu v?y, nhu là
such as	d?n n?i, d?n m?c
suck	bú, hút; h?p th?, ti?p thu
sudden	thình lình, d?t ng?t
suddenly	thình lình, d?t ng?t
suffer	ch?u d?ng, ch?u thi?t h?i, dau kh?
suffering	s? dau d?n, s? dau kh?
sufficient	d?, thích dáng
sufficiently	d?, thích dáng
sugar	du?ng
suggest	d? ngh?, d? xu?t; g?i
suggestion	s? d? ngh?, s? d? xu?t, s? khêu g?i
suit	b? com lê, trang ph?c; thích h?p, quen, h?p v?i
suitable	h?p, phù h?p, thích h?p v?i
suitcase	va li
suited	h?p, phù h?p, thích h?p v?i
sum	t?ng, toàn b?
summary	b?n tóm t?t
summer	mùa hè
sun	m?t tr?i
sunday	ch? nh?t
superior	cao, ch?t lu?ng cao
supermarket	siêu th?
supply	s? cung c?p, ngu?n cung c?p; cung c?p, dáp ?ng, ti?p t?
support	s? ch?ng d?, s? ?ng h?; ch?ng d?, ?ng h?
supporter	v?t ch?ng d?; ngu?i c? vu, ngu?i ?ng h?
suppose	cho r?ng, tin r?ng, nghi r?ng
sure	ch?c ch?n, xác th?c
surely	ch?c ch?n
surface	m?t, b? m?t
surname	h?
surprise	s? ng?c nhiên, s? b?t ng?; làm ng?c nhiên, gây b?t ng?
surprised	ng?c nhiên
surprising	làm ng?c nhiên, làm b?t ng?
surprisingly	làm ng?c nhiên, làm b?t ng?
surround	vây quanh, bao quanh
surrounding	s? vây quanh, s? bao quanh
surroundings	vùng xung quanh, môi tru?ng xung quanh
survey	s? nhìn chung, s? kh?o sát; quan sát, nhìn chung, kh?o sát, nghiên c?u
survive	s?ng lâu hon, ti?p t?c s?ng, s?ng sót
suspect	nghi ng?, hoài nghi; ngu?i kh? nghi, ngu?i b? tình nghi
suspicion	s? nghi ng?, s? ng? v?c
suspicious	có s? nghi ng?, t? ra nghi ng?, kh? nghi
swallow	nu?t, nu?t ch?ng
swear	ch?i r?a, nguy?n r?a; th?, h?a
swearing	l?i th?, l?i nguy?n r?a, l?i th? h?a
sweat	m? hôi; d? m? hôi
sweater	ngu?i ra m? hôi,, k? bóc l?t lao d?ng
sweep	quét
sweet	ng?t, có v? ng?t; s? ng?t bùi, d? ng?t
swell	ph?ng, sung lên
swelling	s? sung lên, s? ph?ng ra
swim	boi l?i
swimming	s? boi l?i
swimming pool	b? nu?c
swing	s? du dua, lúc l?c; dánh du, du dua, lúc l?c
switch	công t?c, roi; t?t, b?t, dánh b?ng g?y, roi
switch  off	ng?t di?n
switch  on	b?t di?n
swollen	sung ph?ng, phình cang
swollen swell	ph?ng lên, sung lên
symbol	bi?u tu?ng, ký hi?u
sympathetic	d?ng c?m, dáng m?n, d? thuong
sympathy	s? d?ng c?m, s? d?ng ý
system	h? th?ng, ch? d?
table	cái bàn
tablet	t?m, b?n, th? phi?n
tackle	gi?i quy?t, kh?c ph?c, bàn th?o; d? dùng, d?ng c?
tail	duôi, do?n cu?i
take	s? c?m n?m, s? l?y
take  over	ch?, chuy?n cái gì; ti?p qu?n, k? t?c cái gì
take advantage of	l?i d?ng
take notice of	chú ý
take place	x?y ra, du?c c? hành, du?c t? ch?c
take sth off	c?i, b? cái gì, l?y di cái gì
talk	nói chuy?n, trò chuy?n; cu?c trò chuy?n, cu?c th?o lu?n
tall	cao
tank	thùng, két, b?
tap	m? vòi, dóng v?i; vòi, khóa
tape	bang, bang ghi âm; d?i, dây
target	bia, m?c tiêu, dích
task	nhi?m v?, nghia v?, bài t?p, công tác, công vi?c
taste	v?, v? giác; n?m
tax	thu?; dánh thu?
taxi	xe t?c xi
tea	cây chè, trà, chè
teach	d?y
teacher	giáo viên
teaching	s? d?y, công vi?c d?y h?c
team	d?i, nhóm
tear	xé, làm r?ch; ch? rách, mi?ng xe; nu?c m?t
technical	k? thu?t, chuyên môn
technique	k? s?o, k? thu?t, phuong pháp k? thu?t
technology	k? thu?t h?c, công ngh? h?c
telephone	máy di?n tho?i, g?i di?n tho?i
television	vô tuy?n truy?n hình
tell	nói, nói v?i
temperature	nhi?t d?
temporarily	t?m
temporary	t?m th?i, nh?t th?i
tend	trông nom, cham sóc, gi? gìn, h?u h?
tendency	xu hu?ng, chi?u hu?ng, khuynh hu?ng
tension	s? cang, d? cang, tình tr?ng cang
tent	l?u, r?p
term	gi?i h?n, k? h?n, khóa, k? h?c
terrible	kh?ng khi?p, ghê s?
terribly	t?i t?, không ch?u n?i
test	bài ki?m tra, s? th? nghi?m, xét nghi?m; ki?m tra, xét nghi?m, th? nghi?m
text	nguyên van, b?n van, ch? d?, d? tì
than	hon
thank	cám on
thank you	c?m on b?n
thanks	s? c?m on, l?i c?m on
that	ngu?i ?y, dó, v?t ?y, dó; r?ng, là
the definite article	cái, con, ngu?i, ?y này....
the rest	v?t, cái còn l?i, nh?ng ngu?i, cái khác
theatre	r?p hát, nhà hát
their	c?a chúng, c?a chúng nó, c?a h?
theirs	c?a chúng, c?a chúng nó, c?a h?
them	chúng, chúng nó, h?
theme	d? tài, ch? d?
themselves	t? chúng, t? h?, t?
then	khi dó, lúc dó, ti?p dó
theory	lý thuy?t, h?c thuy?t
there	? noi dó, t?i noi dó
therefore	b?i v?y, cho nên, vì th?
they	chúng, chúng nó, h?; nh?ng cái ?y
thick	dày; d?m
thickly	dày; dày d?c; thành l?p dày
thickness	tính ch?t dày, d? dày, b? dày
thief	k? tr?m, k? c?p
thin	m?ng, m?nh
thing	cái, d?, v?t
think	nghi, suy nghi
thinking	s? suy nghi, ý nghi
thirsty	khát, c?m th?y khát
this	cái này, di?u này, vi?c này
thorough	c?n th?n, k? lu?ng
thoroughly	k? lu?ng, th?u dáo, tri?t d?
though	dù, dù cho, m?c dù; m?c dù, tuy nhiên, tuy v?y
thought	s? suy nghi, kh? nang suy nghi; ý nghi, tu tu?ng, tu duy
thread	ch?, s?i ch?, s?i dây
threat	s? de d?a, l?i de d?a
threaten	d?a, de d?a
threatening	s? de d?a, s? ham d?a
throat	c?, c? h?ng
through	qua, xuyên qua
throughout	kh?p, su?t
throw	ném, v?t, quang
thumb	ngón tay cái
thursday	th? 5
thus	nhu v?y, nhu th?, do dó
ticket	vé
tidy	s?ch s?, ngan n?p, g?n gàng; làm cho s?ch s?, g?n gàng, ngan n?p
tie	bu?c, c?t, trói; dây bu?c, daay trói, dây giày
tie sth up	có quan h? m?t thi?t, g?n ch?t
tight	kín, ch?t, ch?t
tightly	ch?c ch?, sít sao
till until	cho d?n khi, t?i lúc mà
time	th?i gian, thì gi?
timetable	k? ho?ch làm vi?c, th?i gian bi?u
tin	thi?c
tiny	r?t nh?, nh? xíu
tip	d?u, mút, d?nh, chóp; b?t d?u, l?p d?u vào
tire	làm m?t m?i, tr? nên m?t nh?c; l?p, v? xe
tired	m?t, mu?n ng?, nhàm chán
tiring	s? m?t m?i, s? m?t nh?c
title	d?u d?, tiêu d?; tu?c v?, tu cách
to	theo hu?ng, t?i
today	vào ngày này; hôm nay, ngày nay
toe	ngón chân
together	cùng nhau, cùng v?i
toilet	nhà v? sinh; s? trang di?m
tomato	cà chua
tomorrow	vào ngày mai; ngày mai
ton	t?n
tone	ti?ng, gi?ng
tongue	lu?i
tonight	vào dêm nay, vào t?i nay; dêm nay, t?i nay
tonne	t?n
too	cung
tool	d?ng c?, d? dùng
tooth	rang
top	chóp, d?nh; d?ng d?u, trên h?t
topic	d? tài, ch? d?
total	t?ng c?ng, toàn b?; t?ng s?, toàn b? s? lu?ng
totally	hoàn toàn
touch	s?, mó, ti?p xúc; s? s?, s? mó, s? ti?p xúc
tough	ch?c, b?n, dai
tour	cu?c do du l?ch, cu?c di d?o, chuy?n du l?ch; di du l?ch
tourist	khách du l?ch
towards	theo hu?ng, v? hu?ng
towel	khan t?m, khan lau
tower	tháp
town	th? tr?n, th? xã, thành ph? nh?
toy	d? choi, d? trang trí; th? lo?i d? choi
trace	phát hi?n, tìm th?y, v?ch, ch? ra, phác h?a; d?u, v?t, m?t chút
track	ph?n c?a dia; du?ng mòn, du?ng dua
trade	thuong m?i, buôn bán; buôn bán, trao d?i
trading	s? kinh doanh, vi?c mua bán
tradition	truy?n th?ng
traditional	theo truy?n th?ng, theo l?i c?
traditionally	truy?n th?ng, là truy?n th?ng
traffic	s? di l?i, s? giao thông, s? chuy?n d?ng
train	xe l?a, tàu h?a; d?y, rèn luy?n, dào t?o
training	s? d?y d?, s? hu?n luy?n, s? dào t?o
transfer	d?i, di chuy?n; s? di chuy?n, s? d?i ch?
transform	thay d?i, bi?n d?i
translate	d?ch, biên d?ch, phiên d?ch
translation	s? d?ch
transparent	trong su?t; d? hi?u, sáng s?a
transport	chuyên ch?, v?n t?i
trap	d? d?c, hành lý; b?y, c?m bãy; b?y, gi?, ch?n l?i
travel	di l?i, di du l?ch, di chuy?n; s? di, nh?ng chuy?n di
traveller	ngu?i di, l? khách
treat	d?i x?, d?i dãi, cu x?
treatment	s? d?i x?, s? cu x?
tree	cây
trend	phuong hu?ng, xu hu?ng, chi?u hu?ng
trial	s? th? nghi?m, cu?c th? nghi?m
triangle	hình tam giác
trick	muu m?o, th? do?n, trò l?a gatj; l?a, l?a g?t
trip	cu?c d?o choi, cu?c du ngo?n; di d?o, du ngo?n
tropical	nhi?t d?i
trouble	di?u lo l?ng, di?u mu?n phi?n
trousers	qu?n
truck	rau qu? tuoi
true	dúng, th?t
truly	dúng s? th?t, dích th?c, th?c s?
trust	ni?m tin, s? phó thác; tin, tin c?y, phó thác
truth	s? th?t
try	th?, c? g?ng
tube	?ng, tuýp
tuesday	th? 3
tune	di?u, giai di?u; lên dây, so dây
tunnel	du?ng h?m, hang
turn	quay, xoay, v?n; s? quay, vòng quay
tv television	vô tuy?n truy?n hình
twice	hai l?n
twin	sinh dôi, t?o thành c?p; c?p song sinh
twist	xo?n, cu?n, qu?n; s? xo?n, vòng xo?n
twisted	du?c xo?n, du?c cu?n
type	lo?i, ki?u, m?u; phân lo?i, x?p lo?i
typical	tiêu bi?u, di?n hình, d?c trung
typically	di?n hình, tiêu bi?u
tyre	l?p, v? xe
ugly	x?u xí, x?u xa
ultimate	cu?i cùng, sau cùng
ultimately	cu?i cùng, sau cùng
umbrella	ô, dù
unable	không có nang l?c, không có tài
unable able	không th?, không có kh? nang
unacceptable	không th? ch?p nh?n, không tán thành, không tha th?; không ch?u n?i
unacceptable acceptable	không th? ch?p nh?n
uncertain	thi?u chính xác, không ch?c ch?n
uncertain certain	không ch?c ch?n, khôn bi?t rõ ràng
uncle	chú, bác
uncomfortable	b?t ti?n, khó ch?u, không tho?i mái
uncomfortable comfortable	b?t ti?n, không ti?n l?i
unconscious	b?t t?nh, không có ý th?c, không bi?t rõ
unconscious conscious	b?t t?nh, ng?t di
uncontrolled	không b? di?u khi?n, không b? ki?m tra, không b? h?n
uncontrolled control	không b? ki?m ch?, không b? ki?m tra
under	du?i, ? du?i; ? phía du?i, v? phía du?i
underground	du?i m?t d?t, ng?m du?i d?t; ng?m
underneath	du?i, bên du?i
understand	hi?u, nh?n th?c
understanding	trí tu?, s? hi?u bi?t
underwater	? du?i m?t nu?c, du?i m?t nu?c
underwear	qu?n lót
undo	tháo, g?; xóa b?, h?y b?
undo do	tháo, g?, xóa, h?y b?
unemployed	th?t nghi?p; không dùng, không s? d?ng du?c
unemployed employ	không dùng, th?t nghi?p
unemployment	s? th?t nghi?p, n?n th?t nghi?p
unemployment employment	s? th?t nghi?p, tình tr?ng th?t nghi?p
unexpected	b?t ng?, gây ng?c nhiên
unexpected, unexpectedly	b?t ng?, d?t ng?t, gây ng?c nhiên
unexpectedly	b?t ng?, gây ng?c nhiên
unfair	gian l?n, không công b?ng; b?t l?i
unfair, unfairly fair	không dúng, không công b?ng, gian l?n
unfairly	gian l?n, không công b?ng; b?t l?i
unfortunate	không may, r?i ro, b?t h?nh
unfortunately	m?t cách dáng ti?c, m?t cách không may
unfriendly	không thân thi?n, không có thi?n c?m
unfriendly friendly	d?i d?ch, không thân thi?n
unhappiness	n?i bu?n, s? b?t h?nh
unhappiness happiness	s? bu?n, n?i bu?n
unhappy	bu?n r?u, kh?n kh?
unhappy happy	bu?n r?u, kh? s?
uniform	d?ng ph?c; d?u, gi?ng nhau, d?ng d?ng
unimportant	khônh quan tr?ng, không tr?ng d?i
unimportant important	không quan tr?ng
union	liên hi?p, s? doàn k?t, s? hi?p nh?t
unique	d?c nh?t vô nh?
unit	liên k?t, h?p nh?t, h?p l?i, k?t thân
united	liên minh, doàn k?t, chung, th?ng nh?t
universe	vu tr?
university	tru?ng d?i h?c
unkind	d?c ác, tàn nh?n
unkind kind	không t? t?, không t?t
unknown	không bi?t
unknown know	không bi?t, không du?c nh?n ra
unless	tr? phi, tr? khi, n?u không
unlike	khác, không gi?ng
unlike like	không gi?ng, khác
unlikely	không th? x?y ra, không ch?c x?y ra
unlikely likely	không có th? x?y ra, không ch?c ch?n; không có th?c
unload	c?t gánh n?ng, d? hàng
unload load	tháo, d?
unlucky	không g?p may, b?t h?nh
unlucky lucky	không g?p may, không may m?n
unnecessary	không c?n thi?t, không mong mu?n
unnecessary necessary	không c?n thi?t, không mong mu?n
unpleasant	không d? ch?u, khó ch?u, khó ua
unpleasant pleasant	không d? ch?u, khó ch?u
unreasonable	vô lý
unreasonable reasonable	vô lý, vu?t quá gi?i h?n c?a cái h?p lý
unsteady	không ch?c, không ?n d?nh
unsteady steady	không dúng m?c, không v?ng, không ch?c
unsuccessful	không thành công, th?t b?i
unsuccessful successful	không thành công, không thành d?t
untidy	không g?n gàng, không ngan n?p, l?n x?n
untidy tidy	không g?n gàng, không ngan n?p, l?n x?n
until	tru?c khi, cho d?n khi
unusual	hi?m, khác thu?ng, dáng chú ý
unusual, unusually usual	hi?m, khác thu?ng
unusually	c?c k?, khác thu?ng
unwilling	không s?n lòng, mi?n cu?ng
unwilling, unwillingly willing	không mu?n, không có ý d?nh
unwillingly	không s?n lòng, mi?n cu?ng
up	? trên, lên trên, lên
upon	trên, ? trên
upper	cao hon
upset	làm d?, dánh d?
upsetting	tính dánh d?, làm d?
upside down	l?n ngu?c
upstairs	? tên gác, cu ng? ? t?ng gác; t?ng trên, gác
upward	lên, hu?ng lên, di lên
urban	thành ph?, khu v?c
urge	thúc, gi?c, gi?c giã; s? thúc d?y, s? thôi thúc
urgent	g?p, kh?n c?p
us	chúng tôi, chúng ta; tôi và anh
use	s? d?ng, dùng; s? dùng, s? s? d?ng
used	dã dùng, dã s? d?ng
used to modal	dã quen dùng
used to sth/to doing sth	s? d?ng cái gì, s? d?ng d? làm cái gì
useful	h?u ích, giúp ích
useless	vô ích, vô d?ng
user	ngu?i dùng, ngu?i s? d?ng
usual	thông thu?ng, thu?ng dùng
usually	thu?ng thu?ng
vacation	k? ngh? hè, k? ngh? l?; ngày ngh?, ngày l?
valid	ch?c ch?n, hi?u qu?, h?p lý
valley	thung lung
valuable	có giá tr? l?n, dáng giá
value	giá tr?, u?c tính, d?nh giá
van	ti?n d?i, quân tiên phong; xe t?i
variation	s? bi?n d?i, s? thay d?i m?c d?, s? khác nhau
varied	thu?c nhi?u lo?i khác nhau, nh?ng v? da d?ng
variety	s? da d?ng, tr?ng thái khác nhau
various	khác nhau, thu?c v? nhi?u lo?i
vary	thay d?i, làm cho khác nhau, bi?n d?i
vast	r?ng l?n, mênh mông
vegetable	rau, th?c v?t
vehicle	xe c?
venture	s? án kinh doanh, công vi?c kinh doanh; li?u, m?o hi?m, c? gan
version	b?n d?ch sang m?t ngôn ng? khác
vertical	th?ng d?ng, d?ng
very	r?t, l?m
via	qua, theo du?ng
victim	n?n nhân
victory	chi?n th?ng
video	video
view	s? nhìn, t?m nhìn; nhìn th?y, xem, quan sát
village	làng, xã
violence	s? ác li?t, s? d? d?i; b?o l?c
violent	mãnh li?t, m?nh m?, hung d?
violently	mãnh li?t, d? d?i
virtually	th?c s?, h?u nhu, g?n nhu
virus	vi rút
visible	h?u hình, th?y du?c
vision	s? nhìn, th? l?c
visit	di tham h?i, d?n choi, tham quan; s? di tham, s? tham vi?ng
visitor	khách, du khách
vital	s? s?ng, c?n cho s? s?ng
vocabulary	t? v?ng
voice	ti?ng, gi?ng nói
volume	th? tích, quy?n, t?p
vote	s? b? phi?u, s? b?u c?; b? phi?u, b?u c?
wage	ti?n luong, ti?n công
waist	eo, ch? th?t lung
wait	ch? d?i
waiter, waitress	ngu?i h?u bàn, ngu?i d?i, ngu?i trông ch?
wake	th?c d?y, t?nh th?c
walk	di, di b?; s? di b?, s? di d?o
walking	s? di, s? di b?
wall	tu?ng, vách
wallet	cái ví
wander	di lang thang; s? di lang thang
want	mu?n
war	chi?n tranh
warm	?m, ?m áp; làm cho nóng, hâm nóng
warmth	tr?ng thái ?m, s? ?m áp; hoi ?m
warn	báo cho bi?t, c?nh báo
warning	s? báo tru?c, l?i c?nh báo
wash	r?a, gi?t
washing	s? t?m r?a, s? gi?t
waste	lãng phí, u?ng phí; vùng hoang vu, sa m?c; b? hoang
watch	nhìn, theo dõi, quan sát; s? canh gác, s? canh phòng
water	nu?c
wave	sóng, g?n nu?c; g?n sóng, u?n thành sóng
way	du?ng, du?ng di
we	chúng tôi, chúng ta
weak	y?u, y?u ?t
weakness	tình tr?ng y?u du?i, y?u ?t
wealth	s? giàu có, s? giàu sang
weapon	vu khí
wear	m?c, mang, deo
weather	th?i ti?t
web	m?ng, lu?i
wedding	l? cu?i, hôn l?
wednesday	th? 4
week	tu?n, tu?n l?
weekend	cu?i tu?n
weekly	m?i tu?n m?t l?n, hàng tu?n
weigh	cân, cân n?ng
weight	tr?ng lu?ng
welcome	chào m?ng, hoan nghênh
well	t?t, gi?i; ôi, may quá!
well known	n?i ti?ng, du?c nhi?u ngu?i bi?t d?n
west	phía tây, theo phía tây, v? hu?ng tây
western	v? phía tây, c?a phía tây
wet	u?t, ?m u?t
what	gì, th? nào
whatever	b?t c? th? gì, b?t k? th? gì
wheel	bánh xe
when	khi, lúc, vào lúc nào
whenever	b?t c? lúc nào, lúc nào
where	dâu, ? dâu; noi mà
whereas	nhung ngu?c l?i, trong khi
wherever	? b?t c? noi nào, ? b?t c? noi dâu
whether	có..không; có... chang; không bi?t có.. không
which	nào, b?t c?.. nào; ?y, dó
while	trong lúc, trong khi; lúc, ch?c, lát
whilst	trong lúc, trong khi
whisper	nói thì th?m, xì xào; ti?ng nói thì th?m, ti?ng xì xào
whistle	s? huýt sáo, s? th?i còi; huýt sáo, th?i còi
white	tr?ng; màu tr?ng
who	ai, ngu?i nào, k? nào, ngu?i nhu th? nàow
whole	bình an vô s?, không suy suy?n, không hu h?ng; toàn b?, t?t c?, toàn th?
whom	ai, ngu?i nào; ngu?i mà
whose	c?a ai
why	t?i sao, vì sao
wide	r?ng, r?ng l?n
widely	nhi?u, xa; r?ng rãi
width	tính ch?t r?ng, b? r?ng
wife	v?
wild	d?i, hoang
wildly	d?i, hoang
will modal	s?; ý chí, ý d?nh
willing	b?ng lòng, vui lòng, mu?n
willingly	s?n lòng, t? nguy?n
willingness	s? b?ng lòng, s? vui lòng
win	chi?m, d?at, thu du?c
wind	gió
wind sth up	lên dây, qu?n, gi?i quy?t
window	c?a s?
wine	ru?u, d? u?ng
wing	cánh, s? bay, s? c?t cánh
winner	ngu?i th?ng cu?c
winning	dang dành th?ng l?i, th?ng cu?c
winter	mùa dông
wire	dây
wise	khôn ngoan, sáng su?t, thông thái
wish	u?c, mong mu?n; s? mong u?c, lòng mong mu?n
with	v?i, cùng
withdraw	rút, rút kh?i, rút lui
within	trong vong th?i gian, trong kho?ng th?i gian
without	không, không có
witness	s? làm ch?ng, b?ng ch?ng; ch?ng ki?n, làm ch?ng
woman	dàn bà, ph? n?
wonder	ng?c nhiên, l?y làm l?, kinh ng?c
wonderful	phi thu?ng, khác thu?ng, k? di?u, tuy?t v?i
wood	g?
wooden	làm b?ng g?
wool	len
word	t?
work	làm vi?c, s? làm vi?c
worker	ngu?i lao d?ng
working	s? làm, s? làm vi?c
world	th? gi?i
worried	b?n ch?n, lo nghi, t? ra lo l?ng
worry	lo l?ng, suy nghi; s? lo l?ng, suy nghi
worrying	g?y lo l?ng, gây lo nghi
worship	s? tôn th?, s? tôn sùng; th?, th? ph?ng, tôn th?
worth	dáng giá, có giá tr?
wound	v?t thuong, thuong tích; làm b? thu?ng, gây thuong tích
wounded	b? thuong
wrap	gói, b?c, qu?n
wrapping	v?t bao 
